request_number,request_time_ms,request_received_time_ms,response_time_ms,response_received_time_ms,end_to_end_latency,compute_time,transmission_time
1,1697521543492,1697521549183,1697521565955,1697521566687,23195,16772,6423
2,1697521566714,1697521570841,1697521586997,1697521587531,20817,16156,4661
3,1697521587559,1697521591437,1697521606938,1697521607408,19849,15501,4348
4,1697521607435,1697521610823,1697521627351,1697521627888,20453,16528,3925
5,1697521627915,1697521631849,1697521647454,1697521647851,19936,15605,4331
6,1697521647878,1697521652214,1697521667783,1697521668222,20344,15569,4775
7,1697521668248,1697521671914,1697521688538,1697521688940,20692,16624,4068
8,1697521688967,1697521692948,1697521709355,1697521709843,20876,16407,4469
9,1697521709870,1697521713854,1697521729334,1697521729737,19867,15480,4387
10,1697521729764,1697521734197,1697521750709,1697521751197,21433,16512,4921
11,1697521751223,1697521755431,1697521770821,1697521771239,20016,15390,4626
12,1697521771267,1697521775679,1697521791048,1697521791470,20203,15369,4834
13,1697521791496,1697521795226,1697521810002,1697521810384,18888,14776,4112
14,1697521810411,1697521814682,1697521830322,1697521830702,20291,15640,4651
15,1697521830729,1697521834643,1697521851343,1697521851876,21147,16700,4447
