request_number,request_time_ms,request_received_time_ms,response_time_ms,response_received_time_ms,end_to_end_latency,compute_time,transmission_time
1,1693218740647,1692246476413,1692246477050,1693218741432,785,637,148
2,1693218741432,1692246477224,1692246477656,1693218742140,708,432,276
3,1693218742140,1692246477859,1692246478211,1693218742586,446,352,94
4,1693218742586,1692246478307,1692246478650,1693218743093,507,343,164
5,1693218743093,1692246478807,1692246479109,1693218743531,438,302,136
6,1693218743531,1692246479250,1692246479602,1693218743987,456,352,104
7,1693218743987,1692246479709,1692246480046,1693218744433,446,337,109
8,1693218744433,1692246480142,1692246480477,1693218744861,428,335,93
9,1693218744861,1692246480573,1692246480865,1693218745245,384,292,92
10,1693218745246,1692246480966,1692246481290,1693218745677,431,324,107
11,1693218745677,1692246481417,1692246481642,1693218746033,356,225,131
12,1693218746033,1692246481735,1692246482084,1693218746481,448,349,99
13,1693218746481,1692246482203,1692246482479,1693218746921,440,276,164
14,1693218746921,1692246482630,1692246482953,1693218747343,422,323,99
15,1693218747343,1692246483079,1692246483289,1693218747708,365,210,155
16,1693218747708,1692246483437,1692246483728,1693218748089,381,291,90
17,1693218748089,1692246483826,1692246484120,1693218748534,445,294,151
18,1693218748534,1692246484255,1692246484558,1693218748965,431,303,128
19,1693218748965,1692246484688,1692246485028,1693218749483,518,340,178
20,1693218749483,1692246485188,1692246485546,1693218749969,486,358,128
21,1693218749970,1692246485704,1692246486009,1693218750402,432,305,127
22,1693218750402,1692246486143,1692246486377,1693218750783,381,234,147
23,1693218750783,1692246486483,1692246486876,1693218751235,452,393,59
24,1693218751235,1692246486943,1692246487307,1693218751707,472,364,108
25,1693218751707,1692246487432,1692246487668,1693218752065,358,236,122
26,1693218752065,1692246487799,1692246488075,1693218752459,394,276,118
27,1693218752459,1692246488171,1692246488587,1693218753047,588,416,172
28,1693218753047,1692246488776,1692246489068,1693218753462,415,292,123
29,1693218753462,1692246489187,1692246489495,1693218753867,405,308,97
30,1693218753867,1692246489613,1692246489810,1693218754218,351,197,154
31,1693218754218,1692246489936,1692246490272,1693218754678,460,336,124
32,1693218754678,1692246490412,1692246490775,1693218755153,475,363,112
33,1693218755153,1692246490884,1692246491197,1693218755588,435,313,122
34,1693218755588,1692246491296,1692246491571,1693218755957,369,275,94
35,1693218755957,1692246491692,1692246491984,1693218756376,419,292,127
36,1693218756376,1692246492101,1692246492379,1693218756836,460,278,182
37,1693218756836,1692246492560,1692246492785,1693218757194,358,225,133
38,1693218757194,1692246492936,1692246493204,1693218757598,404,268,136
39,1693218757598,1692246493288,1692246493620,1693218757975,377,332,45
40,1693218757975,1692246493694,1692246494031,1693218758421,446,337,109
41,1693218758421,1692246494146,1692246494444,1693218758838,417,298,119
42,1693218758838,1692246494566,1692246494835,1693218759233,395,269,126
43,1693218759233,1692246494942,1692246495279,1693218759659,426,337,89
44,1693218759659,1692246495384,1692246495630,1693218760041,382,246,136
45,1693218760041,1692246495764,1692246496068,1693218760448,407,304,103
46,1693218760448,1692246496185,1692246496493,1693218760882,434,308,126
47,1693218760882,1692246496591,1692246496805,1693218761153,271,214,57
48,1693218761153,1692246496864,1692246497157,1693218761553,400,293,107
49,1693218761553,1692246497273,1692246497551,1693218761952,399,278,121
50,1693218761952,1692246497667,1692246498045,1693218762422,470,378,92
51,1693218762422,1692246498139,1692246498467,1693218762862,440,328,112
52,1693218762862,1692246498593,1692246498803,1693218763193,331,210,121
53,1693218763193,1692246498915,1692246499258,1693218763633,440,343,97
54,1693218763633,1692246499360,1692246499640,1693218764030,397,280,117
55,1693218764030,1692246499748,1692246500102,1693218764485,455,354,101
56,1693218764485,1692246500211,1692246500532,1693218764916,431,321,110
57,1693218764916,1692246500625,1692246501069,1693218765430,514,444,70
58,1693218765430,1692246501407,1692246501731,1693218766132,702,324,378
59,1693218766132,1692246501861,1692246502223,1693218766604,472,362,110
60,1693218766604,1692246502328,1692246502641,1693218767027,423,313,110
61,1693218767027,1692246502753,1692246503115,1693218767492,465,362,103
62,1693218767492,1692246503206,1692246503612,1693218768005,513,406,107
63,1693218768005,1692246503717,1692246504093,1693218768512,507,376,131
64,1693218768512,1692246504236,1692246504437,1693218768852,340,201,139
65,1693218768852,1692246504585,1692246504850,1693218769253,401,265,136
66,1693218769253,1692246504965,1692246505325,1693218769707,454,360,94
67,1693218769707,1692246505424,1692246505654,1693218770030,323,230,93
68,1693218770030,1692246505757,1692246506033,1693218770427,397,276,121
69,1693218770427,1692246506130,1692246506378,1693218770750,323,248,75
70,1693218770927,1692246506646,1692246507167,1693218771575,648,521,127
71,1693218771575,1692246507291,1692246507814,1693218772199,624,523,101
72,1693218772199,1692246507913,1692246508363,1693218772745,546,450,96
73,1693218772746,1692246508448,1692246508850,1693218773245,499,402,97
74,1693218773245,1692246508944,1692246509458,1693218773830,585,514,71
75,1693218773830,1692246509556,1692246509927,1693218774300,470,371,99
76,1693218774300,1692246510025,1692246510228,1693218774644,344,203,141
77,1693218774644,1692246510360,1692246510900,1693218775300,656,540,116
78,1693218775300,1692246511039,1692246511379,1693218775782,482,340,142
79,1693218775782,1692246511502,1692246511917,1693218776307,525,415,110
80,1693218776307,1692246512043,1692246512305,1693218776710,403,262,141
81,1693218776710,1692246512448,1692246512957,1693218777349,639,509,130
82,1693218777349,1692246513052,1692246513647,1693218778029,680,595,85
83,1693218778029,1692246513767,1692246514014,1693218778425,396,247,149
84,1693218778425,1692246514145,1692246514521,1693218778925,500,376,124
85,1693218778925,1692246514649,1692246515073,1693218779472,547,424,123
86,1693218779472,1692246515187,1692246515581,1693218779975,503,394,109
87,1693218779975,1692246515721,1692246516179,1693218780572,597,458,139
88,1693218780572,1692246516316,1692246516663,1693218781060,488,347,141
89,1693218781060,1692246516783,1692246517218,1693218781609,549,435,114
90,1693218781609,1692246517356,1692246517600,1693218782065,456,244,212
91,1693218782065,1692246517792,1692246518139,1693218782536,471,347,124
92,1693218782536,1692246518272,1692246518561,1693218782960,424,289,135
93,1693218782960,1692246518677,1692246519051,1693218783434,474,374,100
94,1693218783434,1692246519155,1692246519598,1693218783999,565,443,122
95,1693218783999,1692246519709,1692246520298,1693218784677,678,589,89
96,1693218784677,1692246520440,1692246520776,1693218785193,516,336,180
97,1693218785193,1692246520930,1692246521379,1693218785764,571,449,122
98,1693218785764,1692246521492,1692246521848,1693218786238,474,356,118
99,1693218786238,1692246521957,1692246522354,1693218786754,516,397,119
100,1693218786754,1692246522454,1692246522924,1693218787287,533,470,63
101,1693218787287,1692246523012,1692246523423,1693218787830,543,411,132
102,1693218787830,1692246523548,1692246524048,1693218788442,612,500,112
103,1693218788442,1692246524170,1692246524554,1693218788960,518,384,134
104,1693218788960,1692246524668,1692246525052,1693218789455,495,384,111
105,1693218789455,1692246525181,1692246525545,1693218790038,583,364,219
106,1693218790038,1692246525757,1692246526317,1693218790744,706,560,146
107,1693218790744,1692246526456,1692246526796,1693218791184,440,340,100
108,1693218791184,1692246526936,1692246527133,1693218791535,351,197,154
109,1693218791535,1692246527255,1692246527805,1693218792186,651,550,101
110,1693218792186,1692246527923,1692246528192,1693218792594,408,269,139
111,1693218792594,1692246528313,1692246528747,1693218793124,530,434,96
112,1693218793124,1692246528858,1692246529255,1693218793728,604,397,207
113,1693218793728,1692246529455,1692246529790,1693218794179,451,335,116
114,1693218794180,1692246529889,1692246530161,1693218794533,353,272,81
115,1693218794533,1692246530243,1692246530748,1693218795138,605,505,100
116,1693218795138,1692246530847,1692246531322,1693218795778,640,475,165
117,1693218795778,1692246531517,1692246532251,1693218796643,865,734,131
118,1693218796643,1692246532373,1692246532740,1693218797126,483,367,116
119,1693218797126,1692246532858,1692246533277,1693218797713,587,419,168
120,1693218797713,1692246533416,1692246533851,1693218798216,503,435,68
121,1693218798216,1692246533935,1692246534451,1693218798950,734,516,218
122,1693218798950,1692246534657,1692246535031,1693218799427,477,374,103
123,1693218799427,1692246535144,1692246535438,1693218799841,414,294,120
124,1693218799841,1692246535545,1692246536064,1693218800446,605,519,86
125,1693218800446,1692246536182,1692246536456,1693218800862,416,274,142
126,1693218800862,1692246536573,1692246536974,1693218801368,506,401,105
127,1693218801375,1692246537102,1692246537381,1693218801772,397,279,118
128,1693218801772,1692246537498,1692246537817,1693218802205,433,319,114
129,1693218802205,1692246537923,1692246538290,1693218802661,456,367,89
130,1693218802661,1692246538395,1692246538651,1693218803062,401,256,145
131,1693218803062,1692246538785,1692246539123,1693218803486,424,338,86
132,1693218803486,1692246539195,1692246539588,1693218803968,482,393,89
133,1693218803968,1692246539700,1692246539943,1693218804372,404,243,161
134,1693218804372,1692246540090,1692246540399,1693218804775,403,309,94
135,1693218804775,1692246540506,1692246540724,1693218805132,357,218,139
136,1693218805132,1692246540866,1692246541128,1693218805522,390,262,128
137,1693218805522,1692246541248,1692246541520,1693218805906,384,272,112
138,1693218805906,1692246541622,1692246541852,1693218806318,412,230,182
139,1693218806318,1692246542029,1692246542405,1693218806780,462,376,86
140,1693218806780,1692246542502,1692246542777,1693218807226,446,275,171
141,1693218807226,1692246542936,1692246543327,1693218807717,491,391,100
142,1693218807717,1692246543439,1692246543737,1693218808128,411,298,113
143,1693218808128,1692246543874,1692246544074,1693218808491,363,200,163
144,1693218808491,1692246544213,1692246544462,1693218808841,350,249,101
145,1693218808841,1692246544557,1692246544927,1693218809369,528,370,158
146,1693218809369,1692246545098,1692246545326,1693218809792,423,228,195
147,1693218809792,1692246545507,1692246545857,1693218810240,448,350,98
148,1693218810240,1692246545953,1692246546195,1693218810575,335,242,93
149,1693218810575,1692246546306,1692246546545,1693218810944,369,239,130
150,1693218810944,1692246546678,1692246546986,1693218811369,425,308,117
151,1693218811369,1692246547093,1692246547379,1693218811847,478,286,192
152,1693218811847,1692246547566,1692246547911,1693218812289,442,345,97
153,1693218812289,1692246548032,1692246548242,1693218812673,384,210,174
154,1693218812673,1692246548403,1692246548654,1693218813048,375,251,124
155,1693218813048,1692246548762,1692246549042,1693218813447,399,280,119
156,1693218813447,1692246549162,1692246549549,1693218813918,471,387,84
157,1693218813918,1692246549662,1692246549902,1693218814307,389,240,149
158,1693218814307,1692246550025,1692246550380,1693218814877,570,355,215
159,1693218814877,1692246550584,1692246550905,1693218815393,516,321,195
160,1693218815393,1692246551127,1692246551494,1693218815866,473,367,106
161,1693218815866,1692246551652,1692246551983,1693218816368,502,331,171
162,1693218816368,1692246552119,1692246552421,1693218816854,486,302,184
163,1693218816854,1692246552587,1692246552955,1693218817361,507,368,139
164,1693218817361,1692246553092,1692246553306,1693218817706,345,214,131
165,1693218817706,1692246553446,1692246553755,1693218818152,446,309,137
166,1693218818152,1692246553879,1692246554164,1693218818563,411,285,126
167,1693218818563,1692246554275,1692246554593,1693218818979,416,318,98
168,1693218818979,1692246554722,1692246554970,1693218819372,393,248,145
169,1693218819372,1692246555086,1692246555445,1693218819825,453,359,94
170,1693218819825,1692246555578,1692246555806,1693218820206,381,228,153
171,1693218820206,1692246555915,1692246556278,1693218820730,524,363,161
172,1693218820730,1692246556457,1692246556784,1693218821171,441,327,114
173,1693218821171,1692246556893,1692246557264,1693218821636,465,371,94
174,1693218821636,1692246557355,1692246557631,1693218822032,396,276,120
175,1693218822032,1692246557744,1692246558138,1693218822509,477,394,83
176,1693218822509,1692246558227,1692246558650,1693218823024,515,423,92
177,1693218823024,1692246558735,1692246559031,1693218823581,557,296,261
178,1693218823581,1692246559276,1692246559554,1693218823903,322,278,44
179,1693218823903,1692246559618,1692246559878,1693218824228,325,260,65
180,1693218824228,1692246559967,1692246560241,1693218824758,530,274,256
181,1693218824758,1692246560464,1692246560865,1693218825244,486,401,85
182,1693218825244,1692246560970,1692246561254,1693218825787,543,284,259
183,1693218825787,1692246561550,1692246561856,1693218826252,465,306,159
184,1693218826252,1692246561973,1692246562298,1693218826688,436,325,111
185,1693218826688,1692246562406,1692246562716,1693218827095,407,310,97
186,1693218827095,1692246562819,1692246563104,1693218827502,407,285,122
187,1693218827502,1692246563206,1692246563668,1693218828035,533,462,71
188,1693218828035,1692246563763,1692246564059,1693218828533,498,296,202
189,1693218828533,1692246564240,1692246564628,1693218829014,481,388,93
190,1693218829021,1692246564761,1692246565075,1693218829465,444,314,130
191,1693218829465,1692246565204,1692246565454,1693218829848,383,250,133
192,1693218829848,1692246565561,1692246565971,1693218830346,498,410,88
193,1693218830346,1692246566071,1692246566380,1693218830775,429,309,120
194,1693218830775,1692246566496,1692246566726,1693218831128,353,230,123
195,1693218831128,1692246566864,1692246567074,1693218831480,352,210,142
196,1693218831655,1692246567378,1692246568080,1693218832474,819,702,117
197,1693218832474,1692246568257,1692246568730,1693218833144,670,473,197
198,1693218833144,1692246568886,1692246569213,1693218833619,475,327,148
199,1693218833619,1692246569323,1692246569917,1693218834271,652,594,58
200,1693218834271,1692246569984,1692246570688,1693218835078,807,704,103
201,1693218835078,1692246570806,1692246571183,1693218835560,482,377,105
202,1693218835560,1692246571289,1692246571669,1693218836114,554,380,174
203,1693218836114,1692246571815,1692246572298,1693218836686,572,483,89
204,1693218836686,1692246572425,1692246572779,1693218837169,483,354,129
205,1693218837169,1692246572914,1692246573169,1693218837568,399,255,144
206,1693218837568,1692246573305,1692246573740,1693218838133,565,435,130
207,1693218838133,1692246573853,1692246574423,1693218838802,669,570,99
208,1693218838802,1692246574512,1692246574832,1693218839189,387,320,67
209,1693218839189,1692246574909,1692246575329,1693218839718,529,420,109
210,1693218839718,1692246575453,1692246575890,1693218840282,564,437,127
211,1693218840282,1692246576018,1692246576292,1693218840702,420,274,146
212,1693218840702,1692246576415,1692246576913,1693218841289,587,498,89
213,1693218841289,1692246577009,1692246577414,1693218841829,540,405,135
214,1693218841829,1692246577540,1692246577936,1693218842296,467,396,71
215,1693218842296,1692246578016,1692246578356,1693218842739,443,340,103
216,1693218842739,1692246578455,1692246579153,1693218843536,797,698,99
217,1693218843536,1692246579251,1692246579803,1693218844195,659,552,107
218,1693218844195,1692246579934,1692246580259,1693218844654,459,325,134
219,1693218844654,1692246580367,1692246580819,1693218845189,535,452,83
220,1693218845189,1692246580911,1692246581338,1693218845717,528,427,101
221,1693218845717,1692246581427,1692246581849,1693218846223,506,422,84
222,1693218846223,1692246581953,1692246582352,1693218846747,524,399,125
223,1693218846747,1692246582460,1692246582960,1693218847347,600,500,100
224,1693218847347,1692246583070,1692246583343,1693218847722,375,273,102
225,1693218847722,1692246583492,1692246583908,1693218848325,603,416,187
226,1693218848325,1692246584053,1692246584509,1693218848898,573,456,117
227,1693218848898,1692246584639,1692246585182,1693218849575,677,543,134
228,1693218849575,1692246585284,1692246585761,1693218850151,576,477,99
229,1693218850151,1692246585882,1692246586304,1693218850750,599,422,177
230,1693218850750,1692246586490,1692246586990,1693218851375,625,500,125
231,1693218851375,1692246587119,1692246587378,1693218851774,399,259,140
232,1693218851774,1692246587495,1692246588014,1693218852492,718,519,199
233,1693218852492,1692246588199,1692246588565,1693218852989,497,366,131
234,1693218852989,1692246588723,1692246589137,1693218853534,545,414,131
235,1693218853534,1692246589261,1692246589706,1693218854108,574,445,129
236,1693218854108,1692246589830,1692246590097,1693218854467,359,267,92
237,1693218854467,1692246590161,1692246590326,1693218854656,189,165,24
238,1693218854656,1692246590398,1692246590876,1693218855380,724,478,246
239,1693218855380,1692246591098,1692246591364,1693218855785,405,266,139
240,1693218855785,1692246591538,1692246591848,1693218856245,460,310,150
241,1693218856245,1692246591960,1692246592471,1693218856871,626,511,115
242,1693218856871,1692246592611,1692246593001,1693218857393,522,390,132
243,1693218857393,1692246593126,1692246593506,1693218857913,520,380,140
244,1693218857913,1692246593627,1692246594039,1693218858409,496,412,84
245,1693218858409,1692246594123,1692246594461,1693218858910,501,338,163
246,1693218858910,1692246594623,1692246595100,1693218859533,623,477,146
247,1693218859533,1692246595255,1692246595622,1693218860063,530,367,163
248,1693218860063,1692246595779,1692246596339,1693218860724,661,560,101
249,1693218860724,1692246596443,1692246596958,1693218861333,609,515,94
250,1693218861333,1692246597046,1692246597379,1693218861769,436,333,103
251,1693218864787,1692246600517,1692246600935,1693218865320,533,418,115
252,1693218865320,1692246601045,1692246601458,1693218865882,562,413,149
253,1693218865882,1692246601633,1692246601860,1693218866328,446,227,219
254,1693218866328,1692246602072,1692246602324,1693218866723,395,252,143
255,1693218866723,1692246602452,1692246602726,1693218867111,388,274,114
256,1693218867111,1692246602855,1692246603071,1693218867556,445,216,229
257,1693218867556,1692246603289,1692246603595,1693218867984,428,306,122
258,1693218867984,1692246603712,1692246603991,1693218868379,395,279,116
259,1693218868380,1692246604116,1692246604338,1693218868761,381,222,159
260,1693218868762,1692246604475,1692246604842,1693218869212,450,367,83
261,1693218869212,1692246604938,1692246605285,1693218869683,471,347,124
262,1693218869683,1692246605407,1692246605754,1693218870140,457,347,110
263,1693218870140,1692246605880,1692246606121,1693218870524,384,241,143
264,1693218870524,1692246606235,1692246606680,1693218871059,535,445,90
265,1693218871059,1692246606780,1692246607097,1693218871496,437,317,120
266,1693218871496,1692246607236,1692246607590,1693218871973,477,354,123
267,1693218871974,1692246607704,1692246608008,1693218872407,433,304,129
268,1693218872408,1692246608123,1692246608424,1693218872810,402,301,101
269,1693218872810,1692246608525,1692246608883,1693218873259,449,358,91
270,1693218873259,1692246608979,1692246609283,1693218873676,417,304,113
271,1693218873676,1692246609411,1692246609662,1693218874064,388,251,137
272,1693218874064,1692246609775,1692246610215,1693218874588,524,440,84
273,1693218874588,1692246610307,1692246610614,1693218875006,418,307,111
274,1693218875006,1692246610716,1692246611063,1693218875438,432,347,85
275,1693218875438,1692246611154,1692246611516,1693218875922,484,362,122
276,1693218875922,1692246611639,1692246611986,1693218876431,509,347,162
277,1693218876431,1692246612158,1692246612469,1693218876857,426,311,115
278,1693218876857,1692246612575,1692246612968,1693218877394,537,393,144
279,1693218877394,1692246613134,1692246613506,1693218877920,526,372,154
280,1693218877920,1692246613641,1692246613970,1693218878381,461,329,132
281,1693218878381,1692246614120,1692246614424,1693218878814,433,304,129
282,1693218878815,1692246614545,1692246614866,1693218879245,430,321,109
283,1693218879245,1692246614963,1692246615347,1693218879809,564,384,180
284,1693218879809,1692246615532,1692246615873,1693218880252,443,341,102
285,1693218880252,1692246615993,1692246616311,1693218880694,442,318,124
286,1693218880694,1692246616416,1692246616809,1693218881187,493,393,100
287,1693218881187,1692246616904,1692246617279,1693218881658,471,375,96
288,1693218881658,1692246617386,1692246617656,1693218882064,406,270,136
289,1693218882064,1692246617781,1692246618068,1693218882458,394,287,107
290,1693218882458,1692246618194,1692246618431,1693218882844,386,237,149
291,1693218882844,1692246618581,1692246618926,1693218883308,464,345,119
292,1693218883308,1692246619032,1692246619347,1693218883808,500,315,185
293,1693218883808,1692246619517,1692246619859,1693218884311,503,342,161
294,1693218884311,1692246620047,1692246620390,1693218884771,460,343,117
295,1693218884771,1692246620517,1692246620767,1693218885173,402,250,152
296,1693218885173,1692246620900,1692246621133,1693218885537,364,233,131
297,1693218885537,1692246621526,1692246621777,1693218886180,643,251,392
298,1693218886180,1692246621899,1692246622236,1693218886616,436,337,99
299,1693218886616,1692246622337,1692246622726,1693218887098,482,389,93
300,1693218887098,1692246622806,1692246623227,1693218887595,497,421,76
301,1693218887595,1692246623326,1692246623605,1693218888026,431,279,152
302,1693218888026,1692246623730,1692246624070,1693218888423,397,340,57
303,1693218888423,1692246624139,1692246624536,1693218888917,494,397,97
304,1693218888917,1692246624647,1692246624983,1693218889374,457,336,121
305,1693218889374,1692246625080,1692246625343,1693218889704,330,263,67
306,1693218889704,1692246625414,1692246625830,1693218890207,503,416,87
307,1693218890207,1692246625926,1692246626305,1693218890674,467,379,88
308,1693218890674,1692246626406,1692246626687,1693218891072,398,281,117
309,1693218891072,1692246626782,1692246627212,1693218891588,516,430,86
310,1693218891588,1692246627304,1692246627623,1693218892006,418,319,99
311,1693218892006,1692246627726,1692246628074,1693218892454,448,348,100
312,1693218892454,1692246628179,1692246628498,1693218892930,476,319,157
313,1693218892930,1692246628661,1692246628883,1693218893279,349,222,127
314,1693218893279,1692246628980,1692246629299,1693218893660,381,319,62
315,1693218893660,1692246629390,1692246629738,1693218894132,472,348,124
316,1693218894132,1692246629853,1692246630114,1693218894505,373,261,112
317,1693218894505,1692246630229,1692246630528,1693218894901,396,299,97
318,1693218895077,1692246630799,1692246631549,1693218895924,847,750,97
319,1693218895924,1692246631630,1692246632065,1693218896439,515,435,80
320,1693218896439,1692246632162,1692246632596,1693218896987,548,434,114
321,1693218896987,1692246632706,1692246633065,1693218897439,452,359,93
322,1693218897439,1692246633159,1692246633815,1693218898263,824,656,168
323,1693218898263,1692246633982,1692246634392,1693218898875,612,410,202
324,1693218898875,1692246634586,1692246634958,1693218899368,493,372,121
325,1693218899368,1692246635078,1692246635682,1693218900074,706,604,102
326,1693218900074,1692246635803,1692246636140,1693218900528,454,337,117
327,1693218900528,1692246636257,1692246636582,1693218900976,448,325,123
328,1693218900976,1692246636688,1692246637462,1693218901857,881,774,107
329,1693218901857,1692246637591,1692246637903,1693218902300,443,312,131
330,1693218902300,1692246638015,1692246638390,1693218902832,532,375,157
331,1693218902832,1692246638566,1692246639236,1693218903614,782,670,112
332,1693218903614,1692246639357,1692246639647,1693218904029,415,290,125
333,1693218904029,1692246639755,1692246640212,1693218904597,568,457,111
334,1693218904597,1692246640323,1692246640879,1693218905265,668,556,112
335,1693218905265,1692246640986,1692246641481,1693218905868,603,495,108
336,1693218905868,1692246641600,1692246642088,1693218906467,599,488,111
337,1693218906467,1692246642190,1692246642540,1693218906957,490,350,140
338,1693218906957,1692246642682,1692246643200,1693218907583,626,518,108
339,1693218907583,1692246643297,1692246643857,1693218908283,700,560,140
340,1693218908283,1692246643995,1692246644400,1693218908910,627,405,222
341,1693218908910,1692246644630,1692246645208,1693218909585,675,578,97
342,1693218909585,1692246645329,1692246645590,1693218910016,431,261,170
343,1693218910016,1692246645744,1692246646129,1693218910523,507,385,122
344,1693218910523,1692246646261,1692246646779,1693218911161,638,518,120
345,1693218911161,1692246646866,1692246647226,1693218911574,413,360,53
346,1693218911574,1692246647292,1692246647655,1693218912044,470,363,107
347,1693218912044,1692246647785,1692246648062,1693218912456,412,277,135
348,1693218912456,1692246648174,1692246648690,1693218913070,614,516,98
349,1693218913070,1692246648794,1692246649447,1693218913945,875,653,222
350,1693218913945,1692246649676,1692246650305,1693218914757,812,629,183
351,1693218914757,1692246650493,1692246650910,1693218915354,597,417,180
352,1693218915354,1692246651085,1692246651421,1693218915913,559,336,223
353,1693218915913,1692246651659,1692246652012,1693218916387,474,353,121
354,1693218916387,1692246652105,1692246652547,1693218916913,526,442,84
355,1693218916913,1692246652642,1692246653196,1693218917581,668,554,114
356,1693218917581,1692246653321,1692246653767,1693218918189,608,446,162
357,1693218918189,1692246653936,1692246654211,1693218918613,424,275,149
358,1693218918613,1692246654322,1692246654792,1693218919151,538,470,68
359,1693218919151,1692246654885,1692246655199,1693218919587,436,314,122
360,1693218919587,1692246655302,1692246655914,1693218920286,699,612,87
361,1693218920286,1692246656021,1692246656377,1693218920768,482,356,126
362,1693218920768,1692246656493,1692246656858,1693218921240,472,365,107
363,1693218921240,1692246656945,1692246657267,1693218921610,370,322,48
364,1693218921610,1692246657327,1692246657945,1693218922364,754,618,136
365,1693218922364,1692246658098,1692246658535,1693218922939,575,437,138
366,1693218922939,1692246658689,1692246659062,1693218923472,533,373,160
367,1693218923472,1692246659196,1692246659666,1693218924050,578,470,108
368,1693218924050,1692246659763,1692246660122,1693218924528,478,359,119
369,1693218924528,1692246660255,1692246660828,1693218925224,696,573,123
370,1693218928239,1692246663957,1692246664357,1693218928766,527,400,127
371,1693218928766,1692246664509,1692246664717,1693218929127,361,208,153
372,1693218929127,1692246664839,1692246665270,1693218929691,564,431,133
373,1693218929691,1692246665402,1692246665763,1693218930193,502,361,141
374,1693218930193,1692246665914,1692246666280,1693218930722,529,366,163
375,1693218930722,1692246666446,1692246666748,1693218931139,417,302,115
376,1693218931139,1692246666848,1692246667096,1693218931446,307,248,59
377,1693218931446,1692246667160,1692246667424,1693218931777,331,264,67
378,1693218931777,1692246667497,1692246667859,1693218932245,468,362,106
379,1693218932245,1692246667962,1692246668235,1693218932624,379,273,106
380,1693218932624,1692246668337,1692246668658,1693218933034,410,321,89
381,1693218933034,1692246668755,1692246668986,1693218933381,347,231,116
382,1693218933381,1692246669125,1692246669339,1693218933732,351,214,137
383,1693218933732,1692246669457,1692246669770,1693218934159,427,313,114
384,1693218934159,1692246669878,1692246670089,1693218934471,312,211,101
385,1693218934471,1692246670179,1692246670596,1693218934969,498,417,81
386,1693218934969,1692246670682,1692246671029,1693218935425,456,347,109
387,1693218935425,1692246671148,1692246671442,1693218935828,403,294,109
388,1693218935828,1692246671551,1692246671922,1693218936307,479,371,108
389,1693218936307,1692246672021,1692246672391,1693218936750,443,370,73
390,1693218936750,1692246672484,1692246672711,1693218937123,373,227,146
391,1693218937123,1692246672856,1692246673134,1693218937535,412,278,134
392,1693218937535,1692246673247,1692246673622,1693218938066,531,375,156
393,1693218938066,1692246673848,1692246674128,1693218938608,542,280,262
394,1693218938608,1692246674321,1692246674697,1693218939089,481,376,105
395,1693218939089,1692246674835,1692246675158,1693218939549,460,323,137
396,1693218939549,1692246675292,1692246675560,1693218940062,513,268,245
397,1693218940062,1692246675827,1692246676058,1693218940463,401,231,170
398,1693218940463,1692246676158,1692246676478,1693218940834,371,320,51
399,1693218940834,1692246676553,1692246676853,1693218941222,388,300,88
400,1693218941222,1692246676950,1692246677273,1693218941658,436,323,113
401,1693218941658,1692246677383,1692246677770,1693218942135,477,387,90
402,1693218942135,1692246677884,1692246678222,1693218942604,469,338,131
403,1693218942604,1692246678325,1692246678644,1693218943054,450,319,131
404,1693218943054,1692246678780,1692246679094,1693218943478,424,314,110
405,1693218943478,1692246679186,1692246679562,1693218943968,490,376,114
406,1693218943968,1692246679716,1692246679920,1693218944312,344,204,140
407,1693218944312,1692246680041,1692246680367,1693218944748,436,326,110
408,1693218944748,1692246680473,1692246680797,1693218945184,436,324,112
409,1693218945184,1692246680918,1692246681205,1693218945595,411,287,124
410,1693218945595,1692246681316,1692246681741,1693218946120,525,425,100
411,1693218946120,1692246681847,1692246682179,1693218946565,445,332,113
412,1693218946565,1692246682303,1692246682575,1693218947020,455,272,183
413,1693218947020,1692246682721,1692246682879,1693218947218,198,158,40
414,1693218947218,1692246682935,1692246683372,1693218947804,586,437,149
415,1693218947804,1692246683540,1692246683902,1693218948332,528,362,166
416,1693218948332,1692246684051,1692246684460,1693218948841,509,409,100
417,1693218948841,1692246684563,1692246684881,1693218949262,421,318,103
418,1693218949262,1692246685002,1692246685280,1693218949697,435,278,157
419,1693218949697,1692246685433,1692246685688,1693218950072,375,255,120
420,1693218950072,1692246685799,1692246686011,1693218950421,349,212,137
421,1693218950421,1692246686133,1692246686515,1693218950878,457,382,75
422,1693218950878,1692246686614,1692246686801,1693218951206,328,187,141
423,1693218951206,1692246686912,1692246687242,1693218951614,408,330,78
424,1693218951614,1692246687320,1692246687678,1693218952052,438,358,80
425,1693218952052,1692246687792,1692246688042,1693218952435,383,250,133
426,1693218952435,1692246688153,1692246688463,1693218952857,422,310,112
427,1693218952857,1692246688568,1692246688878,1693218953266,409,310,99
428,1693218953266,1692246688976,1692246689472,1693218953844,578,496,82
429,1693218953844,1692246689559,1692246689939,1693218954312,468,380,88
430,1693218954312,1692246690038,1692246690352,1693218954766,454,314,140
431,1693218954766,1692246690514,1692246690780,1693218955227,461,266,195
432,1693218955227,1692246690958,1692246691188,1693218955577,350,230,120
433,1693218955577,1692246691292,1692246691682,1693218956089,512,390,122
434,1693218956089,1692246691859,1692246692204,1693218956586,497,345,152
435,1693218956586,1692246692320,1692246692661,1693218957025,439,341,98
436,1693218957025,1692246692732,1692246693092,1693218957458,433,360,73
437,1693218957458,1692246693173,1692246693540,1693218957927,469,367,102
438,1693218957927,1692246693660,1692246693956,1693218958351,424,296,128
439,1693218958529,1692246694240,1692246694740,1693218959130,601,500,101
440,1693218959130,1692246694864,1692246695348,1693218959739,609,484,125
441,1693218959739,1692246695476,1692246695938,1693218960330,591,462,129
442,1693218960330,1692246696063,1692246696398,1693218960785,455,335,120
443,1693218960785,1692246696510,1692246696948,1693218961337,552,438,114
444,1693218961337,1692246697060,1692246697735,1693218962119,782,675,107
445,1693218962119,1692246697878,1692246698114,1693218962512,393,236,157
446,1693218962512,1692246698259,1692246698640,1693218963043,531,381,150
447,1693218963043,1692246698783,1692246699134,1693218963556,513,351,162
448,1693218963556,1692246699269,1692246699543,1693218963987,431,274,157
449,1693218963987,1692246699701,1692246700127,1693218964511,524,426,98
450,1693218964511,1692246700236,1692246700629,1693218965025,514,393,121
451,1693218965025,1692246700754,1692246701120,1693218965514,489,366,123
452,1693218965514,1692246701237,1692246701529,1693218965879,365,292,73
453,1693218965879,1692246701600,1692246701979,1693218966401,522,379,143
454,1693218966401,1692246702129,1692246702464,1693218966862,461,335,126
455,1693218966862,1692246702583,1692246702970,1693218967354,492,387,105
456,1693218967354,1692246703081,1692246703544,1693218967935,581,463,118
457,1693218967935,1692246703670,1692246704122,1693218968515,580,452,128
458,1693218968515,1692246704236,1692246704575,1693218968955,440,339,101
459,1693218968955,1692246704672,1692246705032,1693218969412,457,360,97
460,1693218969412,1692246705147,1692246705491,1693218969887,475,344,131
461,1693218969887,1692246705606,1692246706164,1693218970548,661,558,103
462,1693218970549,1692246706292,1692246706656,1693218971067,518,364,154
463,1693218971067,1692246706785,1692246707237,1693218971613,546,452,94
464,1693218971613,1692246707343,1692246707803,1693218972205,592,460,132
465,1693218972205,1692246707936,1692246708315,1693218972717,512,379,133
466,1693218972717,1692246708459,1692246708954,1693218973427,710,495,215
467,1693218973427,1692246709150,1692246709741,1693218974139,712,591,121
468,1693218974139,1692246709880,1692246710157,1693218974547,408,277,131
469,1693218974547,1692246710265,1692246710727,1693218975106,559,462,97
470,1693218975107,1692246710823,1692246711264,1693218975644,537,441,96
471,1693218975645,1692246711641,1692246712142,1693218976611,966,501,465
472,1693218976611,1692246712323,1692246712525,1693218976874,263,202,61
473,1693218976874,1692246712601,1692246713011,1693218977402,528,410,118
474,1693218977402,1692246713127,1692246713513,1693218977904,502,386,116
475,1693218977904,1692246713631,1692246714140,1693218978541,637,509,128
476,1693218978541,1692246714299,1692246714564,1693218978966,425,265,160
477,1693218978966,1692246714677,1692246715316,1693218979751,785,639,146
478,1693218979751,1692246715495,1692246715937,1693218980395,644,442,202
479,1693218980395,1692246716120,1692246716456,1693218980846,451,336,115
480,1693218980846,1692246716577,1692246716979,1693218981374,528,402,126
481,1693218981374,1692246717123,1692246717402,1693218981804,430,279,151
482,1693218981804,1692246717527,1692246718066,1693218982433,629,539,90
483,1693218982433,1692246718177,1692246718547,1693218982944,511,370,141
484,1693218982944,1692246718659,1692246719207,1693218983582,638,548,90
485,1693218983582,1692246719296,1692246719633,1693218984004,422,337,85
486,1693218984004,1692246719724,1692246720241,1693218984627,623,517,106
487,1693218984627,1692246720343,1692246720679,1693218985073,446,336,110
488,1693218985073,1692246720787,1692246721309,1693218985687,614,522,92
489,1693218985687,1692246721387,1692246721733,1693218986080,393,346,47
490,1693218986080,1692246721821,1692246722072,1693218986495,415,251,164
491,1693218986495,1692246722215,1692246722677,1693218987077,582,462,120
492,1693218987077,1692246722794,1692246723299,1693218987756,679,505,174
493,1693218987756,1692246723472,1692246723950,1693218988362,606,478,128
494,1693218988362,1692246724085,1692246724554,1693218988989,627,469,158
495,1693218988995,1692246724706,1692246725049,1693218989415,420,343,77
496,1693218989415,1692246725140,1692246725458,1693218989844,429,318,111
497,1693218989844,1692246725591,1692246725883,1693218990287,443,292,151
498,1693218990287,1692246726006,1692246726322,1693218990695,408,316,92
499,1693218990695,1692246726422,1692246726797,1693218991167,472,375,97
500,1693218991167,1692246726908,1692246727174,1693218991566,399,266,133
501,1693218991566,1692246727301,1692246727562,1693218991951,385,261,124
502,1693218991951,1692246727681,1692246727978,1693218992356,405,297,108
503,1693218992356,1692246728103,1692246728328,1693218992734,378,225,153
504,1693218992734,1692246728452,1692246728835,1693218993212,478,383,95
505,1693218993212,1692246728932,1692246729299,1693218993681,469,367,102
506,1693218993681,1692246729426,1692246729640,1693218994081,400,214,186
507,1693218994081,1692246729805,1692246730132,1693218994512,431,327,104
508,1693218994512,1692246730225,1692246730570,1693218994958,446,345,101
509,1693218994958,1692246730671,1692246731038,1693218995418,460,367,93
510,1693218995418,1692246731153,1692246731431,1693218995823,405,278,127
511,1693218995823,1692246731535,1692246731887,1693218996247,424,352,72
512,1693218996248,1692246731963,1692246732332,1693218996714,466,369,97
513,1693218996714,1692246732425,1692246732835,1693218997208,494,410,84
514,1693218997208,1692246732927,1692246733350,1693218997784,576,423,153
515,1693218997784,1692246733508,1692246733800,1693218998181,397,292,105
516,1693218998181,1692246733902,1692246734263,1693218998635,454,361,93
517,1693218998635,1692246734363,1692246734667,1693218999059,424,304,120
518,1693218999059,1692246734782,1692246735109,1693218999470,411,327,84
519,1693218999470,1692246735197,1692246735519,1693218999912,442,322,120
520,1693218999912,1692246735627,1692246736038,1693219000439,527,411,116
521,1693219000439,1692246736133,1692246736476,1693219000835,396,343,53
522,1693219000835,1692246736548,1692246736992,1693219001361,526,444,82
523,1693219001361,1692246737107,1692246737395,1693219001794,433,288,145
524,1693219001794,1692246737501,1692246737856,1693219002286,492,355,137
525,1693219002286,1692246738007,1692246738366,1693219002747,461,359,102
526,1693219002747,1692246738462,1692246738824,1693219003205,458,362,96
527,1693219003205,1692246738930,1692246739276,1693219003654,449,346,103
528,1693219003654,1692246739376,1692246739738,1693219004129,475,362,113
529,1693219004129,1692246739837,1692246740244,1693219004618,489,407,82
530,1693219004618,1692246740351,1692246740593,1693219005072,454,242,212
531,1693219005072,1692246740793,1692246741092,1693219005568,496,299,197
532,1693219005568,1692246741293,1692246741602,1693219006014,446,309,137
533,1693219006014,1692246741766,1692246742077,1693219006467,453,311,142
534,1693219006467,1692246742183,1692246742413,1693219006822,355,230,125
535,1693219006822,1692246742578,1692246742776,1693219007191,369,198,171
536,1693219007191,1692246742900,1692246743277,1693219007799,608,377,231
537,1693219007799,1692246743531,1692246743808,1693219008225,426,277,149
538,1693219008225,1692246743959,1692246744260,1693219008653,428,301,127
539,1693219008653,1692246744372,1692246744662,1693219009052,399,290,109
540,1693219009053,1692246744761,1692246745059,1693219009411,358,298,60
541,1693219009411,1692246745133,1692246745449,1693219009873,462,316,146
542,1693219009873,1692246745607,1692246745878,1693219010274,401,271,130
543,1693219010274,1692246745990,1692246746361,1693219010723,449,371,78
544,1693219010723,1692246746467,1692246746711,1693219011115,392,244,148
545,1693219011115,1692246746845,1692246747074,1693219011472,357,229,128
546,1693219011472,1692246747205,1692246747445,1693219011933,461,240,221
547,1693219011933,1692246747689,1692246747957,1693219012361,428,268,160
548,1693219012361,1692246748087,1692246748347,1693219012726,365,260,105
549,1693219012726,1692246748459,1692246748724,1693219013114,388,265,123
550,1693219013114,1692246748847,1692246749197,1693219013582,468,350,118
551,1693219013582,1692246749332,1692246749599,1693219013999,417,267,150
552,1693219013999,1692246749719,1692246749986,1693219014384,385,267,118
553,1693219014384,1692246750107,1692246750511,1693219014884,500,404,96
554,1693219014884,1692246750631,1692246750834,1693219015287,403,203,200
555,1693219015287,1692246751012,1692246751309,1693219015712,425,297,128
556,1693219015712,1692246751427,1692246751747,1693219016127,415,320,95
557,1693219016127,1692246751836,1692246752160,1693219016516,389,324,65
558,1693219016516,1692246752239,1692246752578,1693219016950,434,339,95
559,1693219016950,1692246752660,1692246753026,1693219017402,452,366,86
560,1693219017402,1692246753125,1692246753439,1693219017854,452,314,138
561,1693219017854,1692246753579,1692246753864,1693219018253,399,285,114
562,1693219018253,1692246753979,1692246754308,1693219018703,450,329,121
563,1693219018703,1692246754431,1692246754752,1693219019143,440,321,119
564,1693219019319,1692246755047,1692246755489,1693219019909,590,442,148
565,1693219019909,1692246755627,1692246756182,1693219020560,651,555,96
566,1693219020560,1692246756271,1692246756881,1693219021266,706,610,96
567,1693219021266,1692246756996,1692246757334,1693219021738,472,338,134
568,1693219021738,1692246757465,1692246757878,1693219022267,529,413,116
569,1693219022267,1692246757987,1692246758566,1693219022988,721,579,142
570,1693219022988,1692246758712,1692246759026,1693219023422,434,314,120
571,1693219023422,1692246759150,1692246759542,1693219023923,501,392,109
572,1693219023923,1692246759653,1692246760148,1693219024520,597,495,102
573,1693219024520,1692246760215,1692246760580,1693219024936,416,365,51
574,1693219024936,1692246760693,1692246760894,1693219025298,362,201,161
575,1693219025298,1692246761009,1692246761542,1693219025911,613,533,80
576,1693219025911,1692246761637,1692246762193,1693219026565,654,556,98
577,1693219026565,1692246762304,1692246762538,1693219026955,390,234,156
578,1693219026955,1692246762671,1692246763509,1693219027885,930,838,92
579,1693219027885,1692246763591,1692246764063,1693219028439,554,472,82
580,1693219028439,1692246764178,1692246764710,1693219029092,653,532,121
581,1693219029092,1692246764815,1692246765416,1693219029795,703,601,102
582,1693219029795,1692246765514,1692246765917,1693219030292,497,403,94
583,1693219030292,1692246766027,1692246766329,1693219030770,478,302,176
584,1693219030770,1692246766521,1692246766854,1693219031233,463,333,130
585,1693219031233,1692246766949,1692246767408,1693219031780,547,459,88
586,1693219031780,1692246767503,1692246767872,1693219032299,519,369,150
587,1693219032299,1692246768039,1692246768490,1693219032937,638,451,187
588,1693219032937,1692246768657,1692246769050,1693219033457,520,393,127
589,1693219033457,1692246769176,1692246769647,1693219034019,562,471,91
590,1693219034019,1692246769732,1692246770499,1693219034873,854,767,87
591,1693219034873,1692246770605,1692246770937,1693219035334,461,332,129
592,1693219035334,1692246771067,1692246771343,1693219035744,410,276,134
593,1693219035744,1692246771672,1692246772021,1693219036434,690,349,341
594,1693219036434,1692246772153,1692246772606,1693219037009,575,453,122
595,1693219037009,1692246772731,1692246773235,1693219037636,627,504,123
596,1693219037636,1692246773349,1692246773852,1693219038236,600,503,97
597,1693219038236,1692246773957,1692246774339,1693219038731,495,382,113
598,1693219038732,1692246774456,1692246774914,1693219039440,708,458,250
599,1693219039440,1692246775155,1692246775582,1693219039967,527,427,100
600,1693219039967,1692246775691,1692246776007,1693219040388,421,316,105
601,1693219040388,1692246776106,1692246776535,1693219040983,595,429,166
602,1693219040983,1692246776730,1692246777173,1693219041560,577,443,134
603,1693219041560,1692246777293,1692246777706,1693219042094,534,413,121
604,1693219042094,1692246777820,1692246778176,1693219042721,627,356,271
605,1693219042721,1692246778596,1692246779102,1693219043482,761,506,255
606,1693219043482,1692246779208,1692246779810,1693219044188,706,602,104
607,1693219044188,1692246779925,1692246780362,1693219044782,594,437,157
608,1693219044782,1692246780500,1692246780810,1693219045204,422,310,112
609,1693219045204,1692246780912,1692246781201,1693219045584,380,289,91
610,1693219045584,1692246781296,1692246781705,1693219046080,496,409,87
611,1693219046080,1692246781839,1692246782172,1693219046570,490,333,157
612,1693219046570,1692246782295,1692246782822,1693219047188,618,527,91
613,1693219047188,1692246782901,1692246783466,1693219047862,674,565,109
614,1693219047862,1692246783574,1692246784103,1693219048482,620,529,91
615,1693219048482,1692246784217,1692246784462,1693219048895,413,245,168
616,1693219048895,1692246784599,1692246785109,1693219049467,572,510,62
617,1693219052482,1692246788221,1692246788479,1693219052920,438,258,180
618,1693219052920,1692246788640,1692246789002,1693219053388,468,362,106
619,1693219053388,1692246789148,1692246789349,1693219053755,367,201,166
620,1693219053755,1692246789458,1692246789763,1693219054111,356,305,51
621,1693219054111,1692246789825,1692246790105,1693219054497,386,280,106
622,1693219054497,1692246790224,1692246790511,1693219054921,424,287,137
623,1693219054921,1692246790645,1692246790949,1693219055334,413,304,109
624,1693219055334,1692246791052,1692246791468,1693219055834,500,416,84
625,1693219055834,1692246791547,1692246791908,1693219056284,450,361,89
626,1693219056284,1692246792025,1692246792242,1693219056644,360,217,143
627,1693219056644,1692246792370,1692246792638,1693219057029,385,268,117
628,1693219057029,1692246792748,1692246793091,1693219057460,431,343,88
629,1693219057460,1692246793173,1692246793563,1693219057982,522,390,132
630,1693219057982,1692246793718,1692246794088,1693219058474,492,370,122
631,1693219058474,1692246794223,1692246794468,1693219058926,452,245,207
632,1693219058926,1692246794662,1692246794925,1693219059315,389,263,126
633,1693219059315,1692246795043,1692246795366,1693219059748,433,323,110
634,1693219059748,1692246795463,1692246795842,1693219060241,493,379,114
635,1693219060241,1692246795979,1692246796301,1693219060756,515,322,193
636,1693219060756,1692246796467,1692246796787,1693219061147,391,320,71
637,1693219061147,1692246796852,1692246797230,1693219061601,454,378,76
638,1693219061601,1692246797349,1692246797646,1693219062035,434,297,137
639,1693219062035,1692246797773,1692246797978,1693219062387,352,205,147
640,1693219062387,1692246798088,1692246798455,1693219062904,517,367,150
641,1693219062904,1692246798631,1692246798903,1693219063295,391,272,119
642,1693219063295,1692246799016,1692246799297,1693219063738,443,281,162
643,1693219063738,1692246799450,1692246799719,1693219064114,376,269,107
644,1693219064114,1692246799868,1692246800070,1693219064477,363,202,161
645,1693219064477,1692246800206,1692246800495,1693219064940,463,289,174
646,1693219064940,1692246800648,1692246801005,1693219065372,432,357,75
647,1693219065372,1692246801119,1692246801405,1693219066004,632,286,346
648,1693219066004,1692246801764,1692246802059,1693219066465,461,295,166
649,1693219066465,1692246802199,1692246802517,1693219066913,448,318,130
650,1693219066913,1692246802623,1692246802946,1693219067312,399,323,76
651,1693219067312,1692246803041,1692246803340,1693219067731,419,299,120
652,1693219067731,1692246803477,1692246803734,1693219068133,402,257,145
653,1693219068133,1692246803844,1692246804035,1693219068385,252,191,61
654,1693219068385,1692246804120,1692246804465,1693219068847,462,345,117
655,1693219068847,1692246804574,1692246804825,1693219069194,347,251,96
656,1693219069194,1692246804913,1692246805185,1693219069544,350,272,78
657,1693219069544,1692246805269,1692246805564,1693219069962,418,295,123
658,1693219069962,1692246805696,1692246805939,1693219070328,366,243,123
659,1693219070328,1692246806038,1692246806396,1693219070764,436,358,78
660,1693219070764,1692246806492,1692246806803,1693219071195,431,311,120
661,1693219071195,1692246806911,1692246807299,1693219071662,467,388,79
662,1693219071662,1692246807387,1692246807722,1693219072100,438,335,103
663,1693219072100,1692246807835,1692246808178,1693219072556,456,343,113
664,1693219072556,1692246808279,1692246808623,1693219072998,442,344,98
665,1693219072998,1692246808724,1692246808994,1693219073342,344,270,74
666,1693219073342,1692246809084,1692246809311,1693219073718,376,227,149
667,1693219073718,1692246809450,1692246809695,1693219074102,384,245,139
668,1693219074102,1692246809833,1692246810160,1693219074555,453,327,126
669,1693219074556,1692246810268,1692246810665,1693219075046,490,397,93
670,1693219075047,1692246810787,1692246811040,1693219075443,396,253,143
671,1693219075443,1692246811173,1692246811476,1693219075901,458,303,155
672,1693219075901,1692246811623,1692246811929,1693219076315,414,306,108
673,1693219076315,1692246812034,1692246812378,1693219076825,510,344,166
674,1693219076825,1692246812572,1692246812806,1693219077209,384,234,150
675,1693219077209,1692246812929,1692246813293,1693219077676,467,364,103
676,1693219077676,1692246813389,1692246813644,1693219078014,338,255,83
677,1693219078014,1692246813753,1692246814061,1693219078469,455,308,147
678,1693219078469,1692246814206,1692246814529,1693219078909,440,323,117
679,1693219078909,1692246814654,1692246814956,1693219079338,429,302,127
680,1693219079338,1692246815058,1692246815346,1693219079790,452,288,164
681,1693219079790,1692246815529,1692246815889,1693219080264,474,360,114
682,1693219080264,1692246815995,1692246816226,1693219080613,349,231,118
683,1693219080613,1692246816344,1692246816652,1693219081027,414,308,106
684,1693219081027,1692246816748,1692246817035,1693219081411,384,287,97
685,1693219081411,1692246817119,1692246817502,1693219081946,535,383,152
686,1693219081946,1692246817674,1692246818009,1693219082384,438,335,103
687,1693219082384,1692246818097,1692246818465,1693219082844,460,368,92
688,1693219083020,1692246818768,1692246819159,1693219083567,547,391,156
689,1693219083567,1692246819279,1692246819769,1693219084132,565,490,75
690,1693219084132,1692246819860,1692246820434,1693219084820,688,574,114
691,1693219084820,1692246820535,1692246820812,1693219085183,363,277,86
692,1693219085183,1692246820898,1692246821509,1693219085871,688,611,77
693,1693219085871,1692246821600,1692246822111,1693219086579,708,511,197
694,1693219086579,1692246822300,1692246822654,1693219087038,459,354,105
695,1693219087038,1692246822759,1692246823250,1693219087627,589,491,98
696,1693219087627,1692246823331,1692246823866,1693219088227,600,535,65
697,1693219088227,1692246823947,1692246824281,1693219088661,434,334,100
698,1693219088661,1692246824368,1692246824729,1693219089104,443,361,82
699,1693219089104,1692246824836,1692246825275,1693219089657,553,439,114
700,1693219089657,1692246825374,1692246825962,1693219090343,686,588,98
701,1693219090343,1692246826075,1692246826372,1693219090767,424,297,127
702,1693219090768,1692246826470,1692246827062,1693219091423,655,592,63
703,1693219091423,1692246827149,1692246827635,1693219092021,598,486,112
704,1693219092021,1692246827742,1692246828192,1693219092607,586,450,136
705,1693219092607,1692246828327,1692246829082,1693219093467,860,755,105
706,1693219093467,1692246829206,1692246829499,1693219093904,437,293,144
707,1693219093904,1692246829621,1692246830043,1693219094430,526,422,104
708,1693219094430,1692246830135,1692246830535,1693219094942,512,400,112
709,1693219094942,1692246830681,1692246830991,1693219095403,461,310,151
710,1693219095403,1692246831118,1692246831415,1693219096008,605,297,308
711,1693219096008,1692246831767,1692246832296,1693219096682,674,529,145
712,1693219096682,1692246832387,1692246832841,1693219097195,513,454,59
713,1693219097195,1692246832921,1692246833305,1693219097725,530,384,146
714,1693219097725,1692246833437,1692246833990,1693219098362,637,553,84
715,1693219098362,1692246834084,1692246834577,1693219098957,595,493,102
716,1693219098957,1692246834674,1692246835032,1693219099409,452,358,94
717,1693219099409,1692246835142,1692246835544,1693219099923,514,402,112
718,1693219099923,1692246835636,1692246836212,1693219100589,666,576,90
719,1693219100590,1692246836315,1692246836707,1693219101095,505,392,113
720,1693219101095,1692246836802,1692246837378,1693219101754,659,576,83
721,1693219101755,1692246837464,1692246837934,1693219102331,576,470,106
722,1693219102331,1692246838057,1692246838471,1693219102854,523,414,109
723,1693219102854,1692246838579,1692246839234,1693219103609,755,655,100
724,1693219103609,1692246839352,1692246839618,1693219104015,406,266,140
725,1693219104015,1692246839746,1692246840094,1693219104472,457,348,109
726,1693219104472,1692246840207,1692246840602,1693219105005,533,395,138
727,1693219105005,1692246840717,1692246841221,1693219105602,597,504,93
728,1693219105602,1692246841338,1692246841668,1693219106094,492,330,162
729,1693219106094,1692246841833,1692246842265,1693219106654,560,432,128
730,1693219106654,1692246842396,1692246842704,1693219107087,433,308,125
731,1693219107087,1692246842806,1692246843202,1693219107650,563,396,167
732,1693219107650,1692246843383,1692246844021,1693219108412,762,638,124
733,1693219108412,1692246844157,1692246844452,1693219108850,438,295,143
734,1693219108850,1692246844576,1692246845045,1693219109426,576,469,107
735,1693219109426,1692246845160,1692246845561,1693219109966,540,401,139
736,1693219109966,1692246845695,1692246846073,1693219110456,490,378,112
737,1693219110456,1692246846176,1692246846697,1693219111058,602,521,81
738,1693219111058,1692246846770,1692246847194,1693219111580,522,424,98
739,1693219111580,1692246847317,1692246847644,1693219112076,496,327,169
740,1693219112076,1692246847799,1692246848263,1693219112684,608,464,144
741,1693219112684,1692246848387,1692246848694,1693219113063,379,307,72
742,1693219116089,1692246851824,1692246852145,1693219116550,461,321,140
743,1693219116550,1692246852271,1692246852634,1693219117009,459,363,96
744,1693219117009,1692246852747,1692246852971,1693219117363,354,224,130
745,1693219117363,1692246853083,1692246853466,1693219117848,485,383,102
746,1693219117848,1692246853567,1692246853921,1693219118305,457,354,103
747,1693219118305,1692246854025,1692246854326,1693219118706,401,301,100
748,1693219118706,1692246854427,1692246854718,1693219119098,392,291,101
749,1693219119098,1692246854824,1692246855100,1693219119518,420,276,144
750,1693219119518,1692246855273,1692246855582,1693219120049,531,309,222
751,1693219120049,1692246855803,1692246856143,1693219120529,480,340,140
752,1693219120529,1692246856270,1692246856593,1693219120979,450,323,127
753,1693219120979,1692246856708,1692246857062,1693219121434,455,354,101
754,1693219121434,1692246857154,1692246857567,1693219121979,545,413,132
755,1693219121979,1692246857708,1692246858037,1693219122420,441,329,112
756,1693219122420,1692246858127,1692246858489,1693219122905,485,362,123
757,1693219122905,1692246858599,1692246858925,1693219123272,367,326,41
758,1693219123272,1692246858994,1692246859388,1693219123839,567,394,173
759,1693219123839,1692246859562,1692246859970,1693219124345,506,408,98
760,1693219124345,1692246860127,1692246860415,1693219124808,463,288,175
761,1693219124808,1692246860537,1692246860941,1693219125313,505,404,101
762,1693219125313,1692246861026,1692246861378,1693219125740,427,352,75
763,1693219125740,1692246861483,1692246861825,1693219126233,493,342,151
764,1693219126233,1692246861969,1692246862278,1693219126705,472,309,163
765,1693219126705,1692246862431,1692246862813,1693219127191,486,382,104
766,1693219127191,1692246862934,1692246863272,1693219127724,533,338,195
767,1693219127724,1692246863455,1692246863665,1693219128056,332,210,122
768,1693219128056,1692246863803,1692246864089,1693219128493,437,286,151
769,1693219128493,1692246864233,1692246864484,1693219128956,463,251,212
770,1693219128956,1692246864684,1692246864971,1693219129357,401,287,114
771,1693219129357,1692246865068,1692246865353,1693219129781,424,285,139
772,1693219129781,1692246865513,1692246865817,1693219130203,422,304,118
773,1693219130203,1692246865928,1692246866273,1693219130691,488,345,143
774,1693219130691,1692246866431,1692246866797,1693219131185,494,366,128
775,1693219131185,1692246866902,1692246867172,1693219131549,364,270,94
776,1693219131549,1692246867301,1692246867638,1693219132025,476,337,139
777,1693219132025,1692246867740,1692246868055,1693219132440,415,315,100
778,1693219132440,1692246868184,1692246868520,1693219132893,453,336,117
779,1693219132893,1692246868626,1692246868923,1693219133292,399,297,102
780,1693219133292,1692246869016,1692246869421,1693219133853,561,405,156
781,1693219133853,1692246869561,1692246869955,1693219134328,475,394,81
782,1693219134328,1692246870076,1692246870395,1693219134783,455,319,136
783,1693219134783,1692246870520,1692246870834,1693219135209,426,314,112
784,1693219135209,1692246870954,1692246871266,1693219135647,438,312,126
785,1693219135647,1692246871385,1692246871666,1693219136051,404,281,123
786,1693219136051,1692246871800,1692246872137,1693219136530,479,337,142
787,1693219136530,1692246872263,1692246872575,1693219136957,427,312,115
788,1693219136957,1692246872688,1692246873003,1693219137384,427,315,112
789,1693219137384,1692246873120,1692246873415,1693219137853,469,295,174
790,1693219137853,1692246873572,1692246873962,1693219138353,500,390,110
791,1693219138353,1692246874092,1692246874416,1693219138802,449,324,125
792,1693219138802,1692246874540,1692246874893,1693219139299,497,353,144
793,1693219139299,1692246875024,1692246875325,1693219139713,414,301,113
794,1693219139713,1692246875435,1692246875786,1693219140160,447,351,96
795,1693219140160,1692246875884,1692246876214,1693219140585,425,330,95
796,1693219140585,1692246876304,1692246876672,1693219141042,457,368,89
797,1693219141042,1692246876754,1692246877111,1693219141475,433,357,76
798,1693219141475,1692246877196,1692246877489,1693219141876,401,293,108
799,1693219141876,1692246877577,1692246877939,1693219142298,422,362,60
800,1693219142298,1692246878037,1692246878301,1693219142695,397,264,133
801,1693219142695,1692246878417,1692246878791,1693219143185,490,374,116
802,1693219143186,1692246878905,1692246879167,1693219143576,390,262,128
803,1693219143576,1692246879297,1692246879580,1693219143960,384,283,101
804,1693219143960,1692246879688,1692246879976,1693219144370,410,288,122
805,1693219144370,1692246880088,1692246880433,1693219144808,438,345,93
806,1693219144808,1692246880526,1692246880814,1693219145172,364,288,76
807,1693219145172,1692246880923,1692246881264,1693219145649,477,341,136
808,1693219145649,1692246881412,1692246881652,1693219146052,403,240,163
809,1693219146052,1692246881772,1692246882166,1693219146555,503,394,109
810,1693219146730,1692246882486,1692246882888,1693219147291,561,402,159
811,1693219147291,1692246883003,1692246883609,1693219147987,696,606,90
812,1693219147987,1692246883727,1692246884289,1693219148671,684,562,122
813,1693219148671,1692246884424,1692246884683,1693219149078,407,259,148
814,1693219149078,1692246884824,1692246885491,1693219149872,794,667,127
815,1693219149872,1692246885618,1692246886004,1693219150487,615,386,229
816,1693219150487,1692246886229,1692246886486,1693219150893,406,257,149
817,1693219150893,1692246886590,1692246887229,1693219151633,740,639,101
818,1693219151633,1692246887352,1692246887817,1693219152193,560,465,95
819,1693219152193,1692246887927,1692246888186,1693219152573,380,259,121
820,1693219152573,1692246888302,1692246888993,1693219153447,874,691,183
821,1693219153447,1692246889194,1692246889480,1693219153971,524,286,238
822,1693219153971,1692246889678,1692246889997,1693219154407,436,319,117
823,1693219154407,1692246890177,1692246890738,1693219155132,725,561,164
824,1693219155132,1692246890903,1692246891230,1693219155624,492,327,165
825,1693219155624,1692246891340,1692246891821,1693219156222,598,481,117
826,1693219156222,1692246891959,1692246892312,1693219156694,472,353,119
827,1693219156694,1692246892441,1692246892883,1693219157347,653,442,211
828,1693219157347,1692246893070,1692246893505,1693219157932,585,435,150
829,1693219157932,1692246893691,1692246894047,1693219158437,505,356,149
830,1693219158437,1692246894149,1692246894693,1693219159065,628,544,84
831,1693219159065,1692246894790,1692246895090,1693219159488,423,300,123
832,1693219159488,1692246895203,1692246895607,1693219159985,497,404,93
833,1693219159985,1692246895720,1692246896100,1693219160498,513,380,133
834,1693219160498,1692246896209,1692246896607,1693219160996,498,398,100
835,1693219160996,1692246896714,1692246897031,1693219161409,413,317,96
836,1693219161409,1692246897120,1692246897530,1693219161928,519,410,109
837,1693219161928,1692246897652,1692246898300,1693219162768,840,648,192
838,1693219162768,1692246898488,1692246899040,1693219163432,664,552,112
839,1693219163432,1692246899171,1692246899509,1693219163890,458,338,120
840,1693219163890,1692246899626,1692246900012,1693219164404,514,386,128
841,1693219164404,1692246900134,1692246900627,1693219165033,629,493,136
842,1693219165033,1692246900789,1692246901165,1693219165575,542,376,166
843,1693219165575,1692246901306,1692246901672,1693219166140,565,366,199
844,1693219166140,1692246901881,1692246902309,1693219166755,615,428,187
845,1693219166755,1692246902476,1692246902870,1693219167262,507,394,113
846,1693219167262,1692246903023,1692246903381,1693219167775,513,358,155
847,1693219167775,1692246903488,1692246904010,1693219168396,621,522,99
848,1693219168396,1692246904124,1692246904572,1693219169008,612,448,164
849,1693219169008,1692246904725,1692246905082,1693219169458,450,357,93
850,1693219169458,1692246905183,1692246905606,1693219170030,572,423,149
851,1693219170030,1692246905741,1692246906268,1693219170739,709,527,182
852,1693219170739,1692246906462,1692246906774,1693219171175,436,312,124
853,1693219171175,1692246906893,1692246907358,1693219171732,557,465,92
854,1693219171732,1692246907446,1692246907909,1693219172304,572,463,109
855,1693219172304,1692246908035,1692246908534,1693219173014,710,499,211
856,1693219173014,1692246908754,1692246909090,1693219173495,481,336,145
857,1693219173495,1692246909216,1692246909793,1693219174216,721,577,144
858,1693219174216,1692246909928,1692246910388,1693219174779,563,460,103
859,1693219174779,1692246910502,1692246910907,1693219175288,509,405,104
860,1693219175288,1692246911024,1692246911435,1693219175841,553,411,142
861,1693219175841,1692246911558,1692246912094,1693219176466,625,536,89
862,1693219176466,1692246912193,1692246912539,1693219176990,524,346,178
863,1693219176997,1692246912719,1692246913100,1693219177477,480,381,99
864,1693219177477,1692246913195,1692246913484,1693219177912,435,289,146
865,1693219177912,1692246913658,1692246913887,1693219178288,376,229,147
866,1693219178288,1692246914017,1692246914285,1693219178737,449,268,181
867,1693219178737,1692246914453,1692246914863,1693219179236,499,410,89
868,1693219179236,1692246914969,1692246915259,1693219179653,417,290,127
869,1693219179653,1692246915372,1692246915695,1693219180077,424,323,101
870,1693219180077,1692246915828,1692246916026,1693219180428,351,198,153
871,1693219180428,1692246916156,1692246916438,1693219180878,450,282,168
872,1693219180878,1692246916586,1692246916913,1693219181278,400,327,73
873,1693219181278,1692246917039,1692246917230,1693219181634,356,191,165
874,1693219181634,1692246917364,1692246917638,1693219182027,393,274,119
875,1693219182027,1692246917757,1692246918082,1693219182460,433,325,108
876,1693219182460,1692246918199,1692246918463,1693219182933,473,264,209
877,1693219182933,1692246918646,1692246919032,1693219183397,464,386,78
878,1693219183397,1692246919111,1692246919463,1693219183832,435,352,83
879,1693219183832,1692246919559,1692246919853,1693219184235,403,294,109
880,1693219184235,1692246919944,1692246920198,1693219184576,341,254,87
881,1693219184576,1692246920306,1692246920559,1693219184957,381,253,128
882,1693219184957,1692246920663,1692246920984,1693219185341,384,321,63
883,1693219185342,1692246921060,1692246921391,1693219185776,434,331,103
884,1693219185776,1692246921507,1692246921808,1693219186227,451,301,150
885,1693219186227,1692246921978,1692246922244,1693219186690,463,266,197
886,1693219186690,1692246922491,1692246922729,1693219187148,458,238,220
887,1693219187148,1692246922875,1692246923192,1693219187572,424,317,107
888,1693219187572,1692246923303,1692246923621,1693219188010,438,318,120
889,1693219188010,1692246923762,1692246924094,1693219188481,471,332,139
890,1693219188481,1692246924223,1692246924559,1693219188956,475,336,139
891,1693219188956,1692246924672,1692246925115,1693219189500,544,443,101
892,1693219189500,1692246925230,1692246925571,1693219189977,477,341,136
893,1693219189977,1692246925703,1692246926034,1693219190427,450,331,119
894,1693219190427,1692246926180,1692246926450,1693219190895,468,270,198
895,1693219190895,1692246926606,1692246927046,1693219191418,523,440,83
896,1693219191418,1692246927132,1692246927580,1693219192029,611,448,163
897,1693219192029,1692246927769,1692246928007,1693219192393,364,238,126
898,1693219192394,1692246928133,1692246928430,1693219192831,437,297,140
899,1693219192831,1692246928563,1692246928900,1693219193268,437,337,100
900,1693219193268,1692246929000,1692246929339,1693219193778,510,339,171
901,1693219193778,1692246929496,1692246929901,1693219194269,491,405,86
902,1693219194269,1692246929988,1692246930311,1693219194743,474,323,151
903,1693219194743,1692246930525,1692246930741,1693219195162,419,216,203
904,1693219195163,1692246930908,1692246931200,1693219195579,416,292,124
905,1693219195579,1692246931298,1692246931696,1693219196067,488,398,90
906,1693219196067,1692246931794,1692246932150,1693219196528,461,356,105
907,1693219196528,1692246932256,1692246932490,1693219196882,354,234,120
908,1693219196882,1692246932612,1692246932927,1693219197312,430,315,115
909,1693219197312,1692246933053,1692246933367,1693219197783,471,314,157
910,1693219197783,1692246933505,1692246933879,1693219198256,473,374,99
911,1693219198256,1692246933969,1692246934307,1693219198700,444,338,106
912,1693219198700,1692246934446,1692246934718,1693219199111,411,272,139
913,1693219199111,1692246934822,1692246935158,1693219199532,421,336,85
914,1693219199532,1692246935237,1692246935527,1693219199882,350,290,60
915,1693219199882,1692246935634,1692246935888,1693219200269,387,254,133
916,1693219200269,1692246936002,1692246936299,1693219200731,462,297,165
917,1693219200731,1692246936444,1692246936905,1693219201360,629,461,168
918,1693219201360,1692246937074,1692246937468,1693219201863,503,394,109
919,1693219201863,1692246937603,1692246937874,1693219202272,409,271,138
920,1693219202272,1692246937998,1692246938377,1693219202752,480,379,101
921,1693219202752,1692246938507,1692246938772,1693219203158,406,265,141
922,1693219203158,1692246938882,1692246939252,1693219203697,539,370,169
923,1693219203697,1692246939421,1692246939826,1693219204205,508,405,103
924,1693219204205,1692246939938,1692246940315,1693219204705,500,377,123
925,1693219204705,1692246940428,1692246940788,1693219205238,533,360,173
926,1693219205238,1692246940975,1692246941291,1693219205662,424,316,108
927,1693219205662,1692246941417,1692246941657,1693219206056,394,240,154
928,1693219206056,1692246941779,1692246942078,1693219206462,406,299,107
929,1693219206462,1692246942177,1692246942519,1693219206911,449,342,107
930,1693219206911,1692246942648,1692246942957,1693219207335,424,309,115
931,1693219207513,1692246943267,1692246943639,1693219208013,500,372,128
932,1693219208013,1692246943740,1692246944211,1693219208616,603,471,132
933,1693219208616,1692246944336,1692246944936,1693219209312,696,600,96
934,1693219209312,1692246945028,1692246945540,1693219209982,670,512,158
935,1693219209982,1692246945716,1692246946232,1693219210618,636,516,120
936,1693219210618,1692246946360,1692246946733,1693219211117,499,373,126
937,1693219211117,1692246946823,1692246947042,1693219211382,265,219,46
938,1693219211382,1692246947106,1692246947585,1693219211965,583,479,104
939,1693219211965,1692246947688,1692246948020,1693219212416,451,332,119
940,1693219212416,1692246948145,1692246948534,1693219212924,508,389,119
941,1693219212924,1692246948639,1692246949109,1693219213479,555,470,85
942,1693219213480,1692246949221,1692246949662,1693219214075,595,441,154
943,1693219214075,1692246949813,1692246950306,1693219214685,610,493,117
944,1693219214685,1692246950411,1692246950890,1693219215294,609,479,130
945,1693219215294,1692246951008,1692246951737,1693219216232,938,729,209
946,1693219216232,1692246951989,1692246952419,1693219216816,584,430,154
947,1693219216816,1692246952570,1692246953016,1693219217411,595,446,149
948,1693219217411,1692246953161,1692246953623,1693219218016,605,462,143
949,1693219218016,1692246953745,1692246954162,1693219218553,537,417,120
950,1693219218553,1692246954275,1692246954793,1693219219160,607,518,89
951,1693219219160,1692246954877,1692246955394,1693219219761,601,517,84
952,1693219219761,1692246955502,1692246955862,1693219220307,546,360,186
953,1693219220307,1692246956017,1692246956508,1693219220882,575,491,84
954,1693219220882,1692246956640,1692246957020,1693219221440,558,380,178
955,1693219221440,1692246957162,1692246957543,1693219221921,481,381,100
956,1693219221921,1692246957665,1692246957917,1693219222350,429,252,177
957,1693219222350,1692246958078,1692246958559,1693219222943,593,481,112
958,1693219222943,1692246958659,1692246959150,1693219223522,579,491,88
959,1693219223522,1692246959241,1692246959505,1693219223886,364,264,100
960,1693219223886,1692246959599,1692246960038,1693219224416,530,439,91
961,1693219224416,1692246960154,1692246960464,1693219224865,449,310,139
962,1693219224865,1692246960597,1692246960955,1693219225346,481,358,123
963,1693219225346,1692246961067,1692246961682,1693219226070,724,615,109
964,1693219226070,1692246961799,1692246962229,1693219226605,535,430,105
965,1693219226605,1692246962344,1692246962724,1693219227117,512,380,132
966,1693219227117,1692246962851,1692246963328,1693219227718,601,477,124
967,1693219227718,1692246963436,1692246963775,1693219228121,403,339,64
968,1693219228121,1692246963850,1692246964275,1693219228658,537,425,112
969,1693219228658,1692246964367,1692246964708,1693219229090,432,341,91
970,1693219229090,1692246964840,1692246965138,1693219229522,432,298,134
971,1693219229522,1692246965239,1692246965719,1693219230092,570,480,90
972,1693219230092,1692246965825,1692246966203,1693219230577,485,378,107
973,1693219230577,1692246966309,1692246966943,1693219231359,782,634,148
974,1693219231359,1692246967123,1692246967436,1693219231890,531,313,218
975,1693219231890,1692246967631,1692246967998,1693219232382,492,367,125
976,1693219232382,1692246968108,1692246968546,1693219233017,635,438,197
977,1693219233017,1692246968749,1692246969184,1693219233559,542,435,107
978,1693219233559,1692246969331,1692246969620,1693219234028,469,289,180
979,1693219234029,1692246969747,1692246970178,1693219234554,525,431,94
980,1693219234554,1692246970264,1692246970598,1693219234939,385,334,51
981,1693219234939,1692246970658,1692246971151,1693219235552,613,493,120
982,1693219235553,1692246971298,1692246971823,1693219236289,736,525,211
983,1693219236289,1692246972023,1692246972643,1693219237104,815,620,195
984,1693219237104,1692246972816,1692246973271,1693219237654,550,455,95
985,1693219240677,1692246976400,1692246976806,1693219241200,523,406,117
986,1693219241200,1692246976929,1692246977251,1693219241637,437,322,115
987,1693219241637,1692246977370,1692246977732,1693219242112,475,362,113
988,1693219242112,1692246977853,1692246978085,1693219242478,366,232,134
989,1693219242478,1692246978188,1692246978608,1693219242978,500,420,80
990,1693219242979,1692246978713,1692246978969,1693219243365,386,256,130
991,1693219243365,1692246979088,1692246979539,1693219243950,585,451,134
992,1693219243950,1692246979683,1692246979942,1693219244356,406,259,147
993,1693219244356,1692246980087,1692246980386,1693219244774,418,299,119
994,1693219244774,1692246980495,1692246980753,1693219245155,381,258,123
995,1693219245155,1692246980920,1692246981231,1693219245614,459,311,148
996,1693219245614,1692246981346,1692246981697,1693219246209,595,351,244
997,1693219246209,1692246981924,1692246982283,1693219246659,450,359,91
998,1693219246659,1692246982419,1692246982696,1693219247139,480,277,203
999,1693219247139,1692246982884,1692246983176,1693219247572,433,292,141
1000,1693219247572,1692246983303,1692246983619,1693219248030,458,316,142
1001,1693219248030,1692246983773,1692246984066,1693219248442,412,293,119
1002,1693219248442,1692246984152,1692246984539,1693219248913,471,387,84
1003,1693219248913,1692246984627,1692246984993,1693219249366,453,366,87
1004,1693219249366,1692246985082,1692246985418,1693219249801,435,336,99
1005,1693219249801,1692246985534,1692246985801,1693219250188,387,267,120
1006,1693219250188,1692246985930,1692246986304,1693219250676,488,374,114
1007,1693219250676,1692246986389,1692246986718,1693219251086,410,329,81
1008,1693219251086,1692246986814,1692246987117,1693219251511,425,303,122
1009,1693219251511,1692246987215,1692246987488,1693219251836,325,273,52
1010,1693219251836,1692246987552,1692246987947,1693219252315,479,395,84
1011,1693219252315,1692246988045,1692246988385,1693219252773,458,340,118
1012,1693219252773,1692246988514,1692246988890,1693219253266,493,376,117
1013,1693219253266,1692246988981,1692246989330,1693219253696,430,349,81
1014,1693219253696,1692246989443,1692246989694,1693219254069,373,251,122
1015,1693219254069,1692246989838,1692246990087,1693219254490,421,249,172
1016,1693219254490,1692246990229,1692246990585,1693219254969,479,356,123
1017,1693219254969,1692246990715,1692246991018,1693219255413,444,303,141
1018,1693219255413,1692246991127,1692246991478,1693219255854,441,351,90
1019,1693219255854,1692246991595,1692246991876,1693219256256,402,281,121
1020,1693219256256,1692246991996,1692246992357,1693219256744,488,361,127
1021,1693219256744,1692246992477,1692246992800,1693219257178,434,323,111
1022,1693219257178,1692246992889,1692246993260,1693219257630,452,371,81
1023,1693219257630,1692246993336,1692246993690,1693219258056,426,354,72
1024,1693219258056,1692246993809,1692246994084,1693219258481,425,275,150
1025,1693219258481,1692246994240,1692246994454,1693219258859,378,214,164
1026,1693219258859,1692246994575,1692246995040,1693219259415,556,465,91
1027,1693219259415,1692246995141,1692246995496,1693219259874,459,355,104
1028,1693219259874,1692246995602,1692246995857,1693219260234,360,255,105
1029,1693219260234,1692246995945,1692246996293,1693219260660,426,348,78
1030,1693219260660,1692246996374,1692246996758,1693219261130,470,384,86
1031,1693219261130,1692246996845,1692246997127,1693219261525,395,282,113
1032,1693219261525,1692246997264,1692246997560,1693219261921,396,296,100
1033,1693219261921,1692246997634,1692246997918,1693219262285,364,284,80
1034,1693219262285,1692246998007,1692246998352,1693219262733,448,345,103
1035,1693219262733,1692246998447,1692246998803,1693219263166,433,356,77
1036,1693219263166,1692246998890,1692246999197,1693219263603,437,307,130
1037,1693219263603,1692246999325,1692246999645,1693219264022,419,320,99
1038,1693219264022,1692246999748,1692247000092,1693219264466,444,344,100
1039,1693219264466,1692247000197,1692247000474,1693219264833,367,277,90
1040,1693219264833,1692247000553,1692247000884,1693219265258,425,331,94
1041,1693219265258,1692247000970,1692247001318,1693219265689,431,348,83
1042,1693219265689,1692247001408,1692247001814,1693219266179,490,406,84
1043,1693219266179,1692247001899,1692247002201,1693219266578,399,302,97
1044,1693219266578,1692247002290,1692247002616,1693219266991,413,326,87
1045,1693219266991,1692247002713,1692247003025,1693219267412,421,312,109
1046,1693219267412,1692247003116,1692247003606,1693219267974,562,490,72
1047,1693219267974,1692247003696,1692247004052,1693219268440,466,356,110
1048,1693219268440,1692247004180,1692247004433,1693219268823,383,253,130
1049,1693219268823,1692247004552,1692247004859,1693219269250,427,307,120
1050,1693219269250,1692247004980,1692247005336,1693219269855,605,356,249
1051,1693219269855,1692247005588,1692247005857,1693219270250,395,269,126
1052,1693219270250,1692247005959,1692247006312,1693219270680,430,353,77
1053,1693219270855,1692247006582,1692247007053,1693219271495,640,471,169
1054,1693219271495,1692247007241,1692247007748,1693219272141,646,507,139
1055,1693219272141,1692247007892,1692247008268,1693219272697,556,376,180
1056,1693219272697,1692247008440,1692247008758,1693219273145,448,318,130
1057,1693219273145,1692247008866,1692247009400,1693219273776,631,534,97
1058,1693219273776,1692247009499,1692247009979,1693219274358,582,480,102
1059,1693219274358,1692247010079,1692247010431,1693219274821,463,352,111
1060,1693219274821,1692247010568,1692247010844,1693219275304,483,276,207
1061,1693219275304,1692247011022,1692247011655,1693219276188,884,633,251
1062,1693219276188,1692247011894,1692247012257,1693219276692,504,363,141
1063,1693219276692,1692247012423,1692247012994,1693219277440,748,571,177
1064,1693219277440,1692247013175,1692247013637,1693219278017,577,462,115
1065,1693219278017,1692247013740,1692247014280,1693219278666,649,540,109
1066,1693219278666,1692247014377,1692247014816,1693219279165,499,439,60
1067,1693219279165,1692247014888,1692247015313,1693219279696,531,425,106
1068,1693219279696,1692247015420,1692247015695,1693219280097,401,275,126
1069,1693219280097,1692247015809,1692247016325,1693219280692,595,516,79
1070,1693219280692,1692247016402,1692247016998,1693219281370,678,596,82
1071,1693219281370,1692247017095,1692247017654,1693219282030,660,559,101
1072,1693219282030,1692247017755,1692247018145,1693219282538,508,390,118
1073,1693219282538,1692247018254,1692247018642,1693219283048,510,388,122
1074,1693219283048,1692247018775,1692247019297,1693219283689,641,522,119
1075,1693219283689,1692247019432,1692247020030,1693219284416,727,598,129
1076,1693219284416,1692247020139,1692247020593,1693219284976,560,454,106
1077,1693219284976,1692247020708,1692247021067,1693219285443,467,359,108
1078,1693219285443,1692247021173,1692247021612,1693219286046,603,439,164
1079,1693219286046,1692247021758,1692247022037,1693219286390,344,279,65
1080,1693219286390,1692247022107,1692247022463,1693219286838,448,356,92
1081,1693219286838,1692247022576,1692247022869,1693219287252,414,293,121
1082,1693219287252,1692247022975,1692247023466,1693219287882,630,491,139
1083,1693219287882,1692247023601,1692247024068,1693219288442,560,467,93
1084,1693219288442,1692247024160,1692247024575,1693219288941,499,415,84
1085,1693219288941,1692247024686,1692247025064,1693219289431,490,378,112
1086,1693219289431,1692247025161,1692247025602,1693219289994,563,441,122
1087,1693219289994,1692247025750,1692247026062,1693219290459,465,312,153
1088,1693219290459,1692247026221,1692247026614,1693219291013,554,393,161
1089,1693219291013,1692247026781,1692247027117,1693219291523,510,336,174
1090,1693219291524,1692247027278,1692247027689,1693219292100,576,411,165
1091,1693219292100,1692247027825,1692247028345,1693219292707,607,520,87
1092,1693219292707,1692247028428,1692247028922,1693219293309,602,494,108
1093,1693219293309,1692247029033,1692247029607,1693219294035,726,574,152
1094,1693219294035,1692247029760,1692247030211,1693219294583,548,451,97
1095,1693219294583,1692247030320,1692247030606,1693219294996,413,286,127
1096,1693219294996,1692247030758,1692247031144,1693219295563,567,386,181
1097,1693219295563,1692247031316,1692247031782,1693219296184,621,466,155
1098,1693219296184,1692247031919,1692247032295,1693219296680,496,376,120
1099,1693219296680,1692247032404,1692247032879,1693219297261,581,475,106
1100,1693219297261,1692247032996,1692247033329,1693219297724,463,333,130
1101,1693219297724,1692247033448,1692247033937,1693219298332,608,489,119
1102,1693219298332,1692247034050,1692247034614,1693219298998,666,564,102
1103,1693219298998,1692247034713,1692247035281,1693219299657,659,568,91
1104,1693219299657,1692247035394,1692247035668,1693219300063,406,274,132
1105,1693219300063,1692247035792,1692247036229,1693219300678,615,437,178
1106,1693219300678,1692247036414,1692247036677,1693219301085,407,263,144
1107,1693219304104,1692247039816,1692247040148,1693219304602,498,332,166
1108,1693219304602,1692247040318,1692247040752,1693219305120,518,434,84
1109,1693219305120,1692247040838,1692247041149,1693219305510,390,311,79
1110,1693219305510,1692247041233,1692247041437,1693219305834,324,204,120
1111,1693219305834,1692247041571,1692247041871,1693219306254,420,300,120
1112,1693219306254,1692247041993,1692247042215,1693219306588,334,222,112
1113,1693219306588,1692247042299,1692247042677,1693219307048,460,378,82
1114,1693219307048,1692247042794,1692247043087,1693219307482,434,293,141
1115,1693219307482,1692247043210,1692247043517,1693219307935,453,307,146
1116,1693219307935,1692247043669,1692247043944,1693219308363,428,275,153
1117,1693219308363,1692247044088,1692247044469,1693219308874,511,381,130
1118,1693219308874,1692247044607,1692247045017,1693219309382,508,410,98
1119,1693219309382,1692247045128,1692247045496,1693219309867,485,368,117
1120,1693219309867,1692247045599,1692247045938,1693219310318,451,339,112
1121,1693219310318,1692247046041,1692247046408,1693219310775,457,367,90
1122,1693219310775,1692247046496,1692247046889,1693219311253,478,393,85
1123,1693219311253,1692247047023,1692247047392,1693219311765,512,369,143
1124,1693219311765,1692247047520,1692247047820,1693219312210,445,300,145
1125,1693219312210,1692247047925,1692247048284,1693219312646,436,359,77
1126,1693219312646,1692247048391,1692247048648,1693219313034,388,257,131
1127,1693219313034,1692247048751,1692247049061,1693219313450,416,310,106
1128,1693219313450,1692247049179,1692247049538,1693219313912,462,359,103
1129,1693219313912,1692247049655,1692247049991,1693219314384,472,336,136
1130,1693219314384,1692247050146,1692247050340,1693219314749,365,194,171
1131,1693219314749,1692247050471,1692247050848,1693219315235,486,377,109
1132,1693219315235,1692247050959,1692247051225,1693219315609,374,266,108
1133,1693219315609,1692247051328,1692247051682,1693219316078,469,354,115
1134,1693219316078,1692247051808,1692247052154,1693219316536,458,346,112
1135,1693219316536,1692247052262,1692247052612,1693219316993,457,350,107
1136,1693219316993,1692247052713,1692247053073,1693219317442,449,360,89
1137,1693219317442,1692247053166,1692247053568,1693219317976,534,402,132
1138,1693219317976,1692247053687,1692247054030,1693219318406,430,343,87
1139,1693219318406,1692247054137,1692247054417,1693219318816,410,280,130
1140,1693219318816,1692247054527,1692247054878,1693219319297,481,351,130
1141,1693219319297,1692247055021,1692247055397,1693219319820,523,376,147
1142,1693219319820,1692247055550,1692247055832,1693219320221,401,282,119
1143,1693219320221,1692247055943,1692247056302,1693219320672,451,359,92
1144,1693219320672,1692247056386,1692247056762,1693219321135,463,376,87
1145,1693219321135,1692247056851,1692247057132,1693219321519,384,281,103
1146,1693219321519,1692247057247,1692247057536,1693219321920,401,289,112
1147,1693219321920,1692247057647,1692247057996,1693219322380,460,349,111
1148,1693219322380,1692247058094,1692247058396,1693219322774,394,302,92
1149,1693219322774,1692247058498,1692247058906,1693219323292,518,408,110
1150,1693219323292,1692247059005,1692247059337,1693219323715,423,332,91
1151,1693219323715,1692247059444,1692247059739,1693219324112,397,295,102
1152,1693219324112,1692247059832,1692247060105,1693219324488,376,273,103
1153,1693219324488,1692247060283,1692247060487,1693219324892,404,204,200
1154,1693219324892,1692247060629,1692247060963,1693219325340,448,334,114
1155,1693219325340,1692247061105,1692247061355,1693219325751,411,250,161
1156,1693219325751,1692247061497,1692247061772,1693219326161,410,275,135
1157,1693219326162,1692247061871,1692247062296,1693219326657,495,425,70
1158,1693219326657,1692247062396,1692247062705,1693219327094,437,309,128
1159,1693219327094,1692247062810,1692247063189,1693219327557,463,379,84
1160,1693219327557,1692247063272,1692247063636,1693219328001,444,364,80
1161,1693219328001,1692247063732,1692247064033,1693219328416,415,301,114
1162,1693219328416,1692247064140,1692247064481,1693219328856,440,341,99
1163,1693219328856,1692247064596,1692247064936,1693219329328,472,340,132
1164,1693219329328,1692247065053,1692247065452,1693219329841,513,399,114
1165,1693219329841,1692247065579,1692247065907,1693219330386,545,328,217
1166,1693219330386,1692247066110,1692247066450,1693219330867,481,340,141
1167,1693219330867,1692247066584,1692247066929,1693219331291,424,345,79
1168,1693219331291,1692247067020,1692247067351,1693219331726,435,331,104
1169,1693219331726,1692247067463,1692247067756,1693219332149,423,293,130
1170,1693219332149,1692247067875,1692247068214,1693219332601,452,339,113
1171,1693219332601,1692247068319,1692247068707,1693219333080,479,388,91
1172,1693219333080,1692247068803,1692247069184,1693219333557,477,381,96
1173,1693219333557,1692247069274,1692247069597,1693219334052,495,323,172
1174,1693219334052,1692247069771,1692247070066,1693219334424,372,295,77
1175,1693219334603,1692247070328,1692247071065,1693219335435,832,737,95
1176,1693219335435,1692247071150,1692247071895,1693219336340,905,745,160
1177,1693219336340,1692247072097,1692247072428,1693219336824,484,331,153
1178,1693219336824,1692247072563,1692247073303,1693219337696,872,740,132
1179,1693219337696,1692247073442,1692247073921,1693219338306,610,479,131
1180,1693219338306,1692247074093,1692247074437,1693219338790,484,344,140
1181,1693219338790,1692247074535,1692247075124,1693219339526,736,589,147
1182,1693219339526,1692247075275,1692247075631,1693219340018,492,356,136
1183,1693219340018,1692247075779,1692247076097,1693219340540,522,318,204
1184,1693219340540,1692247076283,1692247076746,1693219341137,597,463,134
1185,1693219341138,1692247076858,1692247077396,1693219341842,704,538,166
1186,1693219341842,1692247077577,1692247078049,1693219342437,595,472,123
1187,1693219342438,1692247078156,1692247078636,1693219343167,729,480,249
1188,1693219343167,1692247078898,1692247079260,1693219343675,508,362,146
1189,1693219343675,1692247079416,1692247079946,1693219344315,640,530,110
1190,1693219344315,1692247080064,1692247080518,1693219344894,579,454,125
1191,1693219344894,1692247080639,1692247081055,1693219345435,541,416,125
1192,1693219345435,1692247081155,1692247081600,1693219345967,532,445,87
1193,1693219345967,1692247081713,1692247082111,1693219346496,529,398,131
1194,1693219346496,1692247082221,1692247082636,1693219347011,515,415,100
1195,1693219347011,1692247082762,1692247083065,1693219347479,468,303,165
1196,1693219347479,1692247083233,1692247083779,1693219348190,711,546,165
1197,1693219348190,1692247083928,1692247084201,1693219348593,403,273,130
1198,1693219348593,1692247084327,1692247084619,1693219349009,416,292,124
1199,1693219349009,1692247084732,1692247085107,1693219349509,500,375,125
1200,1693219349509,1692247085214,1692247085809,1693219350161,652,595,57
1201,1693219350161,1692247085901,1692247086337,1693219350717,556,436,120
1202,1693219350717,1692247086443,1692247086888,1693219351285,568,445,123
1203,1693219351285,1692247087009,1692247087437,1693219351823,538,428,110
1204,1693219351823,1692247087557,1692247087910,1693219352297,474,353,121
1205,1693219352297,1692247088054,1692247088503,1693219352883,586,449,137
1206,1693219352883,1692247088627,1692247089067,1693219353533,650,440,210
1207,1693219353533,1692247089280,1692247089690,1693219354067,534,410,124
1208,1693219354067,1692247089813,1692247090476,1693219354887,820,663,157
1209,1693219354887,1692247090612,1692247091139,1693219355503,616,527,89
1210,1693219355503,1692247091250,1692247091682,1693219356075,572,432,140
1211,1693219356075,1692247091800,1692247092454,1693219356836,761,654,107
1212,1693219356836,1692247092572,1692247092946,1693219357415,579,374,205
1213,1693219357415,1692247093158,1692247093577,1693219357972,557,419,138
1214,1693219357972,1692247093700,1692247094140,1693219358513,541,440,101
1215,1693219358513,1692247094235,1692247094582,1693219359041,528,347,181
1216,1693219359041,1692247094769,1692247095206,1693219359570,529,437,92
1217,1693219359570,1692247095298,1692247095606,1693219359965,395,308,87
1218,1693219359965,1692247095703,1692247096310,1693219360683,718,607,111
1219,1693219360683,1692247096412,1692247096985,1693219361405,722,573,149
1220,1693219361405,1692247097132,1692247097641,1693219362023,618,509,109
1221,1693219362023,1692247097730,1692247098201,1693219362569,546,471,75
1222,1693219362569,1692247098308,1692247098791,1693219363178,609,483,126
1223,1693219363178,1692247098895,1692247099304,1693219363681,503,409,94
1224,1693219363681,1692247099401,1692247099881,1693219364268,587,480,107
1225,1693219364268,1692247099991,1692247100485,1693219364864,596,494,102
1226,1693219367890,1692247103602,1692247103821,1693219368196,306,219,87
1227,1693219368196,1692247103925,1692247104285,1693219368757,561,360,201
1228,1693219368757,1692247104473,1692247104840,1693219369227,470,367,103
1229,1693219369227,1692247104967,1692247105229,1693219369618,391,262,129
1230,1693219369618,1692247105347,1692247105644,1693219370021,403,297,106
1231,1693219370021,1692247105740,1692247106133,1693219370507,486,393,93
1232,1693219370507,1692247106221,1692247106626,1693219370994,487,405,82
1233,1693219370994,1692247106711,1692247107077,1693219371445,451,366,85
1234,1693219371445,1692247107204,1692247107551,1693219371928,483,347,136
1235,1693219371928,1692247107668,1692247107977,1693219372345,417,309,108
1236,1693219372345,1692247108063,1692247108281,1693219372655,310,218,92
1237,1693219372655,1692247108387,1692247108730,1693219373105,450,343,107
1238,1693219373105,1692247108846,1692247109036,1693219373406,301,190,111
1239,1693219373406,1692247109150,1692247109447,1693219373822,416,297,119
1240,1693219373822,1692247109587,1692247109809,1693219374203,381,222,159
1241,1693219374203,1692247109929,1692247110343,1693219374809,606,414,192
1242,1693219374809,1692247110549,1692247110856,1693219375238,429,307,122
1243,1693219375238,1692247110979,1692247111334,1693219375719,481,355,126
1244,1693219375719,1692247111436,1692247111865,1693219376232,513,429,84
1245,1693219376232,1692247111983,1692247112226,1693219376628,396,243,153
1246,1693219376628,1692247112376,1692247112628,1693219377014,386,252,134
1247,1693219377014,1692247112747,1692247113124,1693219377576,562,377,185
1248,1693219377576,1692247113299,1692247113652,1693219378039,463,353,110
1249,1693219378039,1692247113763,1692247114119,1693219378493,454,356,98
1250,1693219378493,1692247114204,1692247114549,1693219379093,600,345,255
1251,1693219379093,1692247114809,1692247115216,1693219379614,521,407,114
1252,1693219379614,1692247115340,1692247115645,1693219380029,415,305,110
1253,1693219380029,1692247115759,1692247116044,1693219380399,370,285,85
1254,1693219380399,1692247116099,1692247116343,1693219380726,327,244,83
1255,1693219380726,1692247116466,1692247116736,1693219381143,417,270,147
1256,1693219381143,1692247116888,1692247117238,1693219381671,528,350,178
1257,1693219381671,1692247117392,1692247117751,1693219382128,457,359,98
1258,1693219382128,1692247117843,1692247118193,1693219382590,462,350,112
1259,1693219382590,1692247118323,1692247118568,1693219383018,428,245,183
1260,1693219383018,1692247118732,1692247119038,1693219383396,378,306,72
1261,1693219383396,1692247119130,1692247119408,1693219383830,434,278,156
1262,1693219383830,1692247119550,1692247119826,1693219384216,386,276,110
1263,1693219384216,1692247119950,1692247120329,1693219384704,488,379,109
1264,1693219384704,1692247120446,1692247120678,1693219385082,378,232,146
1265,1693219385082,1692247120805,1692247121190,1693219385559,477,385,92
1266,1693219385559,1692247121285,1692247121607,1693219386064,505,322,183
1267,1693219386064,1692247121792,1692247122103,1693219386472,408,311,97
1268,1693219386472,1692247122212,1692247122525,1693219386901,429,313,116
1269,1693219386901,1692247122623,1692247122908,1693219387266,365,285,80
1270,1693219387266,1692247123002,1692247123370,1693219387743,477,368,109
1271,1693219387743,1692247123491,1692247123743,1693219388149,406,252,154
1272,1693219388149,1692247123863,1692247124086,1693219388436,287,223,64
1273,1693219388436,1692247124164,1692247124473,1693219388852,416,309,107
1274,1693219388852,1692247124610,1692247124885,1693219389280,428,275,153
1275,1693219389280,1692247125007,1692247125355,1693219389728,448,348,100
1276,1693219389728,1692247125443,1692247125805,1693219390197,469,362,107
1277,1693219390197,1692247125929,1692247126365,1693219390786,589,436,153
1278,1693219390786,1692247126512,1692247126790,1693219391182,396,278,118
1279,1693219391182,1692247126917,1692247127279,1693219391667,485,362,123
1280,1693219391667,1692247127382,1692247127742,1693219392113,446,360,86
1281,1693219392113,1692247127836,1692247128207,1693219392577,464,371,93
1282,1693219392577,1692247128312,1692247128522,1693219392948,371,210,161
1283,1693219392949,1692247128688,1692247128978,1693219393378,429,290,139
1284,1693219393378,1692247129104,1692247129448,1693219393860,482,344,138
1285,1693219393860,1692247129590,1692247129867,1693219394241,381,277,104
1286,1693219394241,1692247129974,1692247130227,1693219394683,442,253,189
1287,1693219394684,1692247130422,1692247130644,1693219395107,423,222,201
1288,1693219395107,1692247130825,1692247131052,1693219395507,400,227,173
1289,1693219395507,1692247131219,1692247131486,1693219395844,337,267,70
1290,1693219395845,1692247131575,1692247131897,1693219396343,498,322,176
1291,1693219396343,1692247132107,1692247132398,1693219396785,442,291,151
1292,1693219396785,1692247132570,1692247132812,1693219397211,426,242,184
1293,1693219397211,1692247132944,1692247133241,1693219397632,421,297,124
1294,1693219397632,1692247133362,1692247133605,1693219397994,362,243,119
