request_number,request_time_ms,request_received_time_ms,response_time_ms,response_received_time_ms,end_to_end_latency,compute_time,transmission_time
1,1693217379203,1692245115006,1692245116000,1693217380479,1276,994,282
2,1693217380479,1692245116229,1692245116502,1693217381021,542,273,269
3,1693217381021,1692245116764,1692245117035,1693217381460,439,271,168
4,1693217381460,1692245117230,1692245117614,1693217382023,563,384,179
5,1693217382023,1692245117740,1692245118096,1693217382574,551,356,195
6,1693217382574,1692245118333,1692245118543,1693217383023,449,210,239
7,1693217383023,1692245118739,1692245119123,1693217383529,506,384,122
8,1693217383529,1692245119233,1692245119660,1693217384310,781,427,354
9,1693217384310,1692245120053,1692245120246,1693217384636,326,193,133
10,1693217384636,1692245120356,1692245120737,1693217385190,554,381,173
11,1693217385190,1692245120926,1692245121302,1693217385741,551,376,175
12,1693217385741,1692245121445,1692245121726,1693217386189,448,281,167
13,1693217386189,1692245121961,1692245122177,1693217386732,543,216,327
14,1693217386732,1692245122449,1692245122730,1693217387192,460,281,179
15,1693217387192,1692245122916,1692245123139,1693217387606,414,223,191
16,1693217387606,1692245123328,1692245123582,1693217388023,417,254,163
17,1693217388023,1692245123773,1692245124145,1693217388647,624,372,252
18,1693217388647,1692245124373,1692245124747,1693217389165,518,374,144
19,1693217389165,1692245124930,1692245125159,1693217389593,428,229,199
20,1693217389593,1692245125319,1692245125524,1693217389978,385,205,180
21,1693217389978,1692245125697,1692245125933,1693217390368,390,236,154
22,1693217390368,1692245126083,1692245126384,1693217390880,512,301,211
23,1693217390880,1692245126604,1692245126962,1693217391375,495,358,137
24,1693217391375,1692245127114,1692245127356,1693217391829,454,242,212
25,1693217391829,1692245127576,1692245127824,1693217392296,467,248,219
26,1693217392296,1692245127996,1692245128387,1693217392839,543,391,152
27,1693217392839,1692245128543,1692245128784,1693217393174,335,241,94
28,1693217393174,1692245128905,1692245129258,1693217393688,514,353,161
29,1693217393688,1692245129403,1692245129744,1693217394202,514,341,173
30,1693217394203,1692245129934,1692245130164,1693217394634,431,230,201
31,1693217394634,1692245130373,1692245130574,1693217395013,379,201,178
32,1693217395013,1692245130729,1692245131167,1693217395586,573,438,135
33,1693217395586,1692245131290,1692245131693,1693217396091,505,403,102
34,1693217396091,1692245131789,1692245132115,1693217396533,442,326,116
35,1693217396533,1692245132270,1692245132528,1693217397022,489,258,231
36,1693217397022,1692245132745,1692245132975,1693217397451,429,230,199
37,1693217397451,1692245133168,1692245133546,1693217398047,596,378,218
38,1693217398047,1692245133768,1692245134099,1693217398637,590,331,259
39,1693217398637,1692245134375,1692245134615,1693217399219,582,240,342
40,1693217399219,1692245134935,1692245135314,1693217399737,518,379,139
41,1693217399737,1692245135508,1692245135722,1693217400310,573,214,359
42,1693217400310,1692245136052,1692245136379,1693217400780,470,327,143
43,1693217400780,1692245136491,1692245136825,1693217401238,458,334,124
44,1693217401238,1692245136936,1692245137249,1693217401703,465,313,152
45,1693217401703,1692245137403,1692245137628,1693217402210,507,225,282
46,1693217402210,1692245137906,1692245138195,1693217402811,601,289,312
47,1693217402811,1692245138539,1692245138758,1693217403311,500,219,281
48,1693217403311,1692245139027,1692245139320,1693217403813,502,293,209
49,1693217403813,1692245139538,1692245139834,1693217404355,542,296,246
50,1693217404355,1692245140056,1692245140331,1693217404889,534,275,259
51,1693217404889,1692245140594,1692245140949,1693217405383,494,355,139
52,1693217405383,1692245141125,1692245141331,1693217405839,456,206,250
53,1693217405839,1692245141543,1692245141913,1693217406429,590,370,220
54,1693217406429,1692245142138,1692245142413,1693217406812,383,275,108
55,1693217406812,1692245142532,1692245142816,1693217407449,637,284,353
56,1693217407449,1692245143183,1692245143487,1693217407914,465,304,161
57,1693217407914,1692245143641,1692245144017,1693217408536,622,376,246
58,1693217408536,1692245144238,1692245144605,1693217409031,495,367,128
59,1693217409031,1692245144791,1692245145177,1693217409598,567,386,181
60,1693217409773,1692245145487,1692245146157,1693217410672,899,670,229
61,1693217410672,1692245146416,1692245146903,1693217411374,702,487,215
62,1693217411374,1692245147294,1692245147623,1693217412170,796,329,467
63,1693217412170,1692245147905,1692245148212,1693217412767,597,307,290
64,1693217412767,1692245148468,1692245148796,1693217413222,455,328,127
65,1693217413222,1692245148932,1692245149208,1693217414185,963,276,687
66,1693217414185,1692245149920,1692245150249,1693217414883,698,329,369
67,1693217414883,1692245150628,1692245151003,1693217415513,630,375,255
68,1693217415513,1692245151224,1692245151533,1693217415973,460,309,151
69,1693217415973,1692245151660,1692245152006,1693217416430,457,346,111
70,1693217416430,1692245152134,1692245152487,1693217416961,531,353,178
71,1693217416961,1692245152668,1692245152948,1693217417378,417,280,137
72,1693217417378,1692245153081,1692245153487,1693217417919,541,406,135
73,1693217417919,1692245153661,1692245153862,1693217418385,466,201,265
74,1693217418385,1692245154099,1692245154414,1693217418870,485,315,170
75,1693217418870,1692245154567,1692245154920,1693217419386,516,353,163
76,1693217419386,1692245155102,1692245155438,1693217419894,508,336,172
77,1693217419894,1692245155646,1692245155951,1693217420390,496,305,191
78,1693217420390,1692245156089,1692245156440,1693217420841,451,351,100
79,1693217420841,1692245156537,1692245156887,1693217421308,467,350,117
80,1693217421308,1692245157039,1692245157431,1693217421910,602,392,210
81,1693217421910,1692245157650,1692245157984,1693217422397,487,334,153
82,1693217422397,1692245158111,1692245158374,1693217422793,396,263,133
83,1693217422793,1692245158551,1692245158771,1693217423219,426,220,206
84,1693217423219,1692245158935,1692245159290,1693217423752,533,355,178
85,1693217423752,1692245159518,1692245159718,1693217424161,409,200,209
86,1693217424161,1692245159951,1692245160120,1693217424523,362,169,193
87,1693217424523,1692245160235,1692245160548,1693217424960,437,313,124
88,1693217424960,1692245160670,1692245160923,1693217425385,425,253,172
89,1693217425385,1692245161111,1692245161352,1693217425848,463,241,222
90,1693217425848,1692245161556,1692245161832,1693217426242,394,276,118
91,1693217426242,1692245161945,1692245162263,1693217426646,404,318,86
92,1693217426646,1692245162352,1692245162761,1693217427163,517,409,108
93,1693217427163,1692245162859,1692245163285,1693217427856,693,426,267
94,1693217427856,1692245163590,1692245163850,1693217428374,518,260,258
95,1693217428374,1692245164091,1692245164412,1693217428951,577,321,256
96,1693217428951,1692245164665,1692245164982,1693217429496,545,317,228
97,1693217429496,1692245165217,1692245165619,1693217430086,590,402,188
98,1693217430086,1692245165805,1692245166056,1693217430562,476,251,225
99,1693217430562,1692245166294,1692245166568,1693217431016,454,274,180
100,1693217431016,1692245166711,1692245167020,1693217431467,451,309,142
101,1693217431467,1692245167199,1692245167451,1693217432022,555,252,303
102,1693217432022,1692245167747,1692245168093,1693217432557,535,346,189
103,1693217432558,1692245168270,1692245168661,1693217433059,501,391,110
104,1693217433059,1692245168762,1692245169077,1693217433488,429,315,114
105,1693217433488,1692245169213,1692245169492,1693217433982,494,279,215
106,1693217433982,1692245169696,1692245170068,1693217434497,515,372,143
107,1693217434497,1692245170205,1692245170601,1693217435084,587,396,191
108,1693217435084,1692245170790,1692245171208,1693217435616,532,418,114
109,1693217435616,1692245171294,1692245171576,1693217436001,385,282,103
110,1693217436001,1692245171705,1692245172060,1693217436450,449,355,94
111,1693217436450,1692245172177,1692245172486,1693217436960,510,309,201
112,1693217436960,1692245172738,1692245173025,1693217437478,518,287,231
113,1693217437478,1692245173245,1692245173518,1693217438028,550,273,277
114,1693217438028,1692245173786,1692245174062,1693217438469,441,276,165
115,1693217438470,1692245174184,1692245174487,1693217438898,428,303,125
116,1693217438898,1692245174613,1692245174926,1693217439397,499,313,186
117,1693217439397,1692245175092,1692245175519,1693217440130,733,427,306
118,1693217443184,1692245178926,1692245179364,1693217443790,606,438,168
119,1693217443790,1692245179505,1692245179794,1693217444442,652,289,363
120,1693217444442,1692245180162,1692245180506,1693217444921,479,344,135
121,1693217444921,1692245180635,1692245180888,1693217445268,347,253,94
122,1693217445268,1692245180982,1692245181321,1693217445723,455,339,116
123,1693217445723,1692245181431,1692245181756,1693217446177,454,325,129
124,1693217446177,1692245181894,1692245182215,1693217446682,505,321,184
125,1693217446682,1692245182393,1692245182711,1693217447098,416,318,98
126,1693217447098,1692245182814,1692245183114,1693217447514,416,300,116
127,1693217447514,1692245183227,1692245183603,1693217448040,526,376,150
128,1693217448040,1692245183768,1692245184089,1693217448657,617,321,296
129,1693217448657,1692245184380,1692245184709,1693217449112,455,329,126
130,1693217449112,1692245184816,1692245185116,1693217449524,412,300,112
131,1693217449524,1692245185267,1692245185517,1693217449939,415,250,165
132,1693217449939,1692245185656,1692245185959,1693217450379,440,303,137
133,1693217450380,1692245186141,1692245186387,1693217450828,448,246,202
134,1693217450828,1692245186527,1692245186799,1693217451208,380,272,108
135,1693217451208,1692245186920,1692245187209,1693217451645,437,289,148
136,1693217451645,1692245187336,1692245187701,1693217452091,446,365,81
137,1693217452091,1692245187798,1692245188086,1693217452478,387,288,99
138,1693217452478,1692245188185,1692245188515,1693217452970,492,330,162
139,1693217452970,1692245188676,1692245188961,1693217453388,418,285,133
140,1693217453388,1692245189109,1692245189383,1693217453805,417,274,143
141,1693217453805,1692245189526,1692245189767,1693217454193,388,241,147
142,1693217454193,1692245189886,1692245190196,1693217454612,419,310,109
143,1693217454612,1692245190326,1692245190679,1693217455095,483,353,130
144,1693217455095,1692245190897,1692245191131,1693217455545,450,234,216
145,1693217455545,1692245191230,1692245191548,1693217455923,378,318,60
146,1693217455923,1692245191621,1692245191985,1693217456375,452,364,88
147,1693217456375,1692245192086,1692245192409,1693217456821,446,323,123
148,1693217456821,1692245192522,1692245192880,1693217457281,460,358,102
149,1693217457281,1692245192997,1692245193303,1693217457707,426,306,120
150,1693217457707,1692245193452,1692245193721,1693217458181,474,269,205
151,1693217458181,1692245193880,1692245194175,1693217458576,395,295,100
152,1693217458576,1692245194280,1692245194607,1693217458984,408,327,81
153,1693217458984,1692245194687,1692245195024,1693217459420,436,337,99
154,1693217459420,1692245195167,1692245195604,1693217460121,701,437,264
155,1693217460121,1692245195849,1692245196144,1693217460546,425,295,130
156,1693217460546,1692245196349,1692245196649,1693217461059,513,300,213
157,1693217461059,1692245196771,1692245197112,1693217461516,457,341,116
158,1693217461516,1692245197212,1692245197609,1693217462042,526,397,129
159,1693217462042,1692245197770,1692245197983,1693217462414,372,213,159
160,1693217462414,1692245198122,1692245198538,1693217462950,536,416,120
161,1693217462950,1692245198660,1692245199013,1693217463419,469,353,116
162,1693217463419,1692245199121,1692245199500,1693217463973,554,379,175
163,1693217463973,1692245199692,1692245200000,1693217464410,437,308,129
164,1693217464410,1692245200121,1692245200446,1693217464899,489,325,164
165,1693217464899,1692245200620,1692245201002,1693217465394,495,382,113
166,1693217465394,1692245201098,1692245201516,1693217465907,513,418,95
167,1693217465907,1692245201611,1692245201987,1693217466441,534,376,158
168,1693217466441,1692245202198,1692245202445,1693217466861,420,247,173
169,1693217466861,1692245202577,1692245202845,1693217467229,368,268,100
170,1693217467229,1692245202936,1692245203344,1693217467769,540,408,132
171,1693217467770,1692245203474,1692245203860,1693217468277,507,386,121
172,1693217468277,1692245203985,1692245204390,1693217468776,499,405,94
173,1693217468776,1692245204488,1692245204829,1693217469231,455,341,114
174,1693217469231,1692245204959,1692245205168,1693217469641,410,209,201
175,1693217469641,1692245205359,1692245205624,1693217470167,526,265,261
176,1693217470167,1692245205865,1692245206248,1693217470633,466,383,83
177,1693217470633,1692245206333,1692245206654,1693217471048,415,321,94
178,1693217471048,1692245206758,1692245207087,1693217471517,469,329,140
179,1693217471517,1692245207216,1692245207615,1693217472025,508,399,109
180,1693217472025,1692245207739,1692245207985,1693217472418,393,246,147
181,1693217472418,1692245208120,1692245208474,1693217472862,444,354,90
182,1693217472862,1692245208633,1692245208947,1693217473371,509,314,195
183,1693217473584,1692245209270,1692245209816,1693217474419,835,546,289
184,1693217474419,1692245210141,1692245210654,1693217475060,641,513,128
185,1693217475060,1692245210784,1692245211033,1693217475464,404,249,155
186,1693217475464,1692245211188,1692245211460,1693217475996,532,272,260
187,1693217475996,1692245211709,1692245212038,1693217476484,488,329,159
188,1693217476484,1692245212210,1692245212553,1693217477019,535,343,192
189,1693217477019,1692245212782,1692245212999,1693217477500,481,217,264
190,1693217477500,1692245213230,1692245213478,1693217477891,391,248,143
191,1693217477891,1692245213587,1692245213942,1693217478446,555,355,200
192,1693217478446,1692245214205,1692245214505,1693217478957,511,300,211
193,1693217478957,1692245214660,1692245214970,1693217479363,406,310,96
194,1693217479363,1692245215086,1692245215341,1693217479761,398,255,143
195,1693217479761,1692245215463,1692245215725,1693217480106,345,262,83
196,1693217480106,1692245215835,1692245216123,1693217480527,421,288,133
197,1693217480527,1692245216255,1692245216553,1693217480982,455,298,157
198,1693217480982,1692245216677,1692245217013,1693217481385,403,336,67
199,1693217481385,1692245217088,1692245217506,1693217481913,528,418,110
200,1693217481913,1692245217638,1692245217876,1693217482345,432,238,194
201,1693217482345,1692245218054,1692245218339,1693217482795,450,285,165
202,1693217482795,1692245218528,1692245218732,1693217483344,549,204,345
203,1693217483344,1692245219042,1692245219456,1693217483866,522,414,108
204,1693217483866,1692245219568,1692245219970,1693217484425,559,402,157
205,1693217484425,1692245220165,1692245220371,1693217484781,356,206,150
206,1693217484781,1692245220490,1692245220859,1693217485259,478,369,109
207,1693217485259,1692245220992,1692245221260,1693217485797,538,268,270
208,1693217485797,1692245221520,1692245221788,1693217486207,410,268,142
209,1693217486207,1692245221922,1692245222202,1693217486627,420,280,140
210,1693217486628,1692245222342,1692245222647,1693217487073,445,305,140
211,1693217487073,1692245222792,1692245223130,1693217487554,481,338,143
212,1693217487554,1692245223302,1692245223691,1693217488103,549,389,160
213,1693217488103,1692245223790,1692245224129,1693217488513,410,339,71
214,1693217488513,1692245224217,1692245224617,1693217489004,491,400,91
215,1693217489004,1692245224712,1692245225082,1693217489479,475,370,105
216,1693217489480,1692245225211,1692245225488,1693217489898,418,277,141
217,1693217489898,1692245225603,1692245226062,1693217490448,550,459,91
218,1693217490448,1692245226153,1692245226546,1693217491001,553,393,160
219,1693217491001,1692245226699,1692245227128,1693217491510,509,429,80
220,1693217491510,1692245227278,1692245227511,1693217491930,420,233,187
221,1693217491930,1692245227652,1692245227938,1693217492317,387,286,101
222,1693217492317,1692245228048,1692245228304,1693217492763,446,256,190
223,1693217492763,1692245228473,1692245228791,1693217493188,425,318,107
224,1693217493188,1692245228908,1692245229189,1693217493635,447,281,166
225,1693217493635,1692245229335,1692245229644,1693217494101,466,309,157
226,1693217494101,1692245229791,1692245230052,1693217494430,329,261,68
227,1693217494430,1692245230162,1692245230469,1693217494874,444,307,137
228,1693217494874,1692245230638,1692245231044,1693217495502,628,406,222
229,1693217495502,1692245231187,1692245231475,1693217495860,358,288,70
230,1693217495860,1692245231605,1692245231866,1693217496255,395,261,134
231,1693217496255,1692245232000,1692245232255,1693217496684,429,255,174
232,1693217496684,1692245232416,1692245232786,1693217497183,499,370,129
233,1693217497183,1692245232986,1692245233264,1693217497741,558,278,280
234,1693217497741,1692245233442,1692245233815,1693217498216,475,373,102
235,1693217498216,1692245233927,1692245234214,1693217498615,399,287,112
236,1693217498615,1692245234315,1692245234751,1693217499136,521,436,85
237,1693217499136,1692245234865,1692245235240,1693217499635,499,375,124
238,1693217499635,1692245235341,1692245235729,1693217500153,518,388,130
239,1693217500153,1692245235889,1692245236260,1693217500752,599,371,228
240,1693217500752,1692245236463,1692245236823,1693217501221,469,360,109
241,1693217501221,1692245236932,1692245237227,1693217501624,403,295,108
242,1693217501624,1692245237336,1692245237669,1693217502099,475,333,142
243,1693217502099,1692245237824,1692245238115,1693217502554,455,291,164
244,1693217502554,1692245238267,1692245238509,1693217502908,354,242,112
245,1693217502908,1692245238608,1692245238980,1693217503371,463,372,91
246,1693217503371,1692245239068,1692245239466,1693217503898,527,398,129
247,1693217506915,1692245242633,1692245242985,1693217507393,478,352,126
248,1693217507393,1692245243114,1692245243471,1693217507910,517,357,160
249,1693217507910,1692245243616,1692245243894,1693217508279,369,278,91
250,1693217508279,1692245243974,1692245244416,1693217508814,535,442,93
251,1693217508814,1692245244527,1692245244771,1693217509183,369,244,125
252,1693217509183,1692245244879,1692245245260,1693217509739,556,381,175
253,1693217509739,1692245245445,1692245245776,1693217510211,472,331,141
254,1693217510211,1692245245918,1692245246307,1693217510709,498,389,109
255,1693217510709,1692245246423,1692245246697,1693217511108,399,274,125
256,1693217511108,1692245246807,1692245247169,1693217511552,444,362,82
257,1693217511552,1692245247268,1692245247488,1693217511923,371,220,151
258,1693217511923,1692245247624,1692245248017,1693217512419,496,393,103
259,1693217512419,1692245248106,1692245248387,1693217512796,377,281,96
260,1693217512796,1692245248508,1692245248839,1693217513233,437,331,106
261,1693217513233,1692245248981,1692245249326,1693217513735,502,345,157
262,1693217513735,1692245249520,1692245249741,1693217514153,418,221,197
263,1693217514153,1692245249876,1692245250123,1693217514566,413,247,166
264,1693217514566,1692245250271,1692245250596,1693217514990,424,325,99
265,1693217514990,1692245250702,1692245251038,1693217515439,449,336,113
266,1693217515439,1692245251146,1692245251477,1693217515885,446,331,115
267,1693217515885,1692245251587,1692245251903,1693217516283,398,316,82
268,1693217516283,1692245251996,1692245252293,1693217516712,429,297,132
269,1693217516712,1692245252446,1692245252700,1693217517128,416,254,162
270,1693217517128,1692245252850,1692245253121,1693217517536,408,271,137
271,1693217517536,1692245253249,1692245253605,1693217518038,502,356,146
272,1693217518038,1692245253743,1692245254140,1693217518539,501,397,104
273,1693217518539,1692245254247,1692245254504,1693217518937,398,257,141
274,1693217518937,1692245254677,1692245254972,1693217519375,438,295,143
275,1693217519375,1692245255104,1692245255454,1693217519882,507,350,157
276,1693217519882,1692245255606,1692245255868,1693217520287,405,262,143
277,1693217520287,1692245256000,1692245256302,1693217520725,438,302,136
278,1693217520725,1692245256458,1692245256759,1693217521180,455,301,154
279,1693217521180,1692245256924,1692245257300,1693217521732,552,376,176
280,1693217521732,1692245257439,1692245257772,1693217522170,438,333,105
281,1693217522170,1692245257904,1692245258250,1693217522645,475,346,129
282,1693217522645,1692245258358,1692245258611,1693217523039,394,253,141
283,1693217523039,1692245258731,1692245259083,1693217523467,428,352,76
284,1693217523467,1692245259161,1692245259506,1693217523888,421,345,76
285,1693217523888,1692245259611,1692245259928,1693217524328,440,317,123
286,1693217524328,1692245260042,1692245260280,1693217524686,358,238,120
287,1693217524686,1692245260438,1692245260644,1693217525261,575,206,369
288,1693217525261,1692245261033,1692245261347,1693217525751,490,314,176
289,1693217525751,1692245261456,1692245261758,1693217526151,400,302,98
290,1693217526151,1692245261867,1692245262203,1693217526615,464,336,128
291,1693217526615,1692245262400,1692245262815,1693217527199,584,415,169
292,1693217527199,1692245262968,1692245263203,1693217527689,490,235,255
293,1693217527689,1692245263414,1692245263747,1693217528148,459,333,126
294,1693217528148,1692245263861,1692245264201,1693217528589,441,340,101
295,1693217528589,1692245264294,1692245264653,1693217529052,463,359,104
296,1693217529052,1692245264753,1692245265127,1693217529602,550,374,176
297,1693217529602,1692245265348,1692245265600,1693217530010,408,252,156
298,1693217530010,1692245265706,1692245265960,1693217530437,427,254,173
299,1693217530437,1692245266139,1692245266498,1693217530904,467,359,108
300,1693217530904,1692245266639,1692245266985,1693217531380,476,346,130
301,1693217531380,1692245267098,1692245267453,1693217531846,466,355,111
302,1693217531846,1692245267554,1692245267768,1693217532212,366,214,152
303,1693217532212,1692245267907,1692245268302,1693217532778,566,395,171
304,1693217532778,1692245268498,1692245268828,1693217533296,518,330,188
305,1693217533296,1692245269026,1692245269237,1693217533780,484,211,273
306,1693217533780,1692245269530,1692245269772,1693217534359,579,242,337
307,1693217534359,1692245270118,1692245270483,1693217534956,597,365,232
308,1693217534956,1692245270684,1692245270958,1693217535423,467,274,193
309,1693217535423,1692245271144,1692245271424,1693217535801,378,280,98
310,1693217535801,1692245271522,1692245271858,1693217536269,468,336,132
311,1693217536269,1692245271976,1692245272348,1693217536807,538,372,166
312,1693217536807,1692245272528,1692245272935,1693217537327,520,407,113
313,1693217537504,1692245273242,1692245273643,1693217538137,633,401,232
314,1693217538137,1692245273868,1692245274361,1693217539071,934,493,441
315,1693217539071,1692245274911,1692245275153,1693217539600,529,242,287
316,1693217539600,1692245275313,1692245275665,1693217540146,546,352,194
317,1693217540146,1692245275927,1692245276229,1693217540638,492,302,190
318,1693217540638,1692245276372,1692245276660,1693217541124,486,288,198
319,1693217541124,1692245276864,1692245277202,1693217541642,518,338,180
320,1693217541642,1692245277373,1692245277683,1693217542088,446,310,136
321,1693217542088,1692245277801,1692245278177,1693217542608,520,376,144
322,1693217542608,1692245278329,1692245278664,1693217543149,541,335,206
323,1693217543149,1692245278839,1692245279137,1693217543528,379,298,81
324,1693217543528,1692245279289,1692245279651,1693217544056,528,362,166
325,1693217544056,1692245279832,1692245280145,1693217544562,506,313,193
326,1693217544562,1692245280264,1692245280619,1693217545021,459,355,104
327,1693217545021,1692245280744,1692245281035,1693217545425,404,291,113
328,1693217545425,1692245281126,1692245281485,1693217545895,470,359,111
329,1693217545895,1692245281630,1692245281860,1693217546295,400,230,170
330,1693217546295,1692245282020,1692245282573,1693217547050,755,553,202
331,1693217547050,1692245282776,1692245283090,1693217547494,444,314,130
332,1693217547494,1692245283196,1692245283412,1693217547851,357,216,141
333,1693217547851,1692245283548,1692245284011,1693217548394,543,463,80
334,1693217548394,1692245284118,1692245284342,1693217548772,378,224,154
335,1693217548772,1692245284493,1692245284768,1693217549210,438,275,163
336,1693217549210,1692245284923,1692245285175,1693217549665,455,252,203
337,1693217549665,1692245285371,1692245285564,1693217549947,282,193,89
338,1693217549947,1692245285669,1692245285993,1693217550407,460,324,136
339,1693217550407,1692245286148,1692245286368,1693217550816,409,220,189
340,1693217550816,1692245286528,1692245286900,1693217551444,628,372,256
341,1693217551444,1692245287151,1692245287495,1693217551909,465,344,121
342,1693217551909,1692245287628,1692245288022,1693217552454,545,394,151
343,1693217552454,1692245288168,1692245288499,1693217552894,440,331,109
344,1693217552894,1692245288628,1692245288923,1693217553355,461,295,166
345,1693217553355,1692245289077,1692245289448,1693217553897,542,371,171
346,1693217553897,1692245289654,1692245289979,1693217554400,503,325,178
347,1693217554400,1692245290132,1692245290480,1693217554935,535,348,187
348,1693217554935,1692245290671,1692245290943,1693217555466,531,272,259
349,1693217555466,1692245291173,1692245291593,1693217556004,538,420,118
350,1693217556004,1692245291709,1692245292070,1693217556480,476,361,115
351,1693217556480,1692245292221,1692245292583,1693217557056,576,362,214
352,1693217557056,1692245292781,1692245293068,1693217557472,416,287,129
353,1693217557472,1692245293169,1692245293542,1693217557951,479,373,106
354,1693217557951,1692245293658,1692245294075,1693217558476,525,417,108
355,1693217558476,1692245294231,1692245294572,1693217559013,537,341,196
356,1693217559013,1692245294759,1692245295134,1693217559540,527,375,152
357,1693217559540,1692245295268,1692245295584,1693217560023,483,316,167
358,1693217560023,1692245295766,1692245296062,1693217560468,445,296,149
359,1693217560469,1692245296228,1692245296447,1693217560868,399,219,180
360,1693217560868,1692245296571,1692245296978,1693217561354,486,407,79
361,1693217561354,1692245297094,1692245297317,1693217561737,383,223,160
362,1693217561737,1692245297464,1692245297713,1693217562125,388,249,139
363,1693217562125,1692245297866,1692245298192,1693217562594,469,326,143
364,1693217562594,1692245298323,1692245298645,1693217563097,503,322,181
365,1693217563097,1692245298793,1692245299180,1693217563560,463,387,76
366,1693217563560,1692245299279,1692245299779,1693217564151,591,500,91
367,1693217564151,1692245300106,1692245300397,1693217564846,695,291,404
368,1693217564846,1692245300568,1692245300802,1693217565201,355,234,121
369,1693217565201,1692245300923,1692245301184,1693217565593,392,261,131
370,1693217565593,1692245301331,1692245301714,1693217566128,535,383,152
371,1693217566128,1692245301839,1692245302281,1693217566658,530,442,88
372,1693217566658,1692245302447,1692245302724,1693217567221,563,277,286
373,1693217567221,1692245302940,1692245303222,1693217567620,399,282,117
374,1693217567629,1692245303339,1692245303607,1693217567998,369,268,101
375,1693217567998,1692245303691,1692245304028,1693217568418,420,337,83
376,1693217568418,1692245304124,1692245304478,1693217568869,451,354,97
377,1693217568869,1692245304561,1692245304906,1693217569278,409,345,64
378,1693217569278,1692245304983,1692245305303,1693217569698,420,320,100
379,1693217569698,1692245305399,1692245305690,1693217570070,372,291,81
380,1693217570070,1692245305768,1692245306140,1693217570536,466,372,94
381,1693217570536,1692245306255,1692245306481,1693217570906,370,226,144
382,1693217570907,1692245306613,1692245306983,1693217571373,466,370,96
383,1693217571373,1692245307070,1692245307434,1693217571825,452,364,88
384,1693217571825,1692245307524,1692245307957,1693217572351,526,433,93
385,1693217572351,1692245308051,1692245308427,1693217572815,464,376,88
386,1693217572815,1692245308519,1692245308869,1693217573258,443,350,93
387,1693217573258,1692245308970,1692245309297,1693217573694,436,327,109
388,1693217573694,1692245309401,1692245309710,1693217574119,425,309,116
389,1693217574119,1692245309821,1692245310165,1693217574554,435,344,91
390,1693217574554,1692245310269,1692245310592,1693217575062,508,323,185
391,1693217575062,1692245310780,1692245311189,1693217575616,554,409,145
392,1693217575616,1692245311383,1692245311672,1693217576084,468,289,179
393,1693217576084,1692245311813,1692245312184,1693217576588,504,371,133
394,1693217576588,1692245312298,1692245312600,1693217576994,406,302,104
395,1693217576994,1692245312722,1692245312966,1693217577424,430,244,186
396,1693217577424,1692245313116,1692245313500,1693217577947,523,384,139
397,1693217577947,1692245313667,1692245313943,1693217578380,433,276,157
398,1693217578380,1692245314105,1692245314350,1693217578753,373,245,128
399,1693217578753,1692245314468,1692245314792,1693217579268,515,324,191
400,1693217579268,1692245314968,1692245315366,1693217579771,503,398,105
401,1693217579771,1692245315496,1692245315803,1693217580248,477,307,170
402,1693217580249,1692245315959,1692245316205,1693217580615,366,246,120
403,1693217580615,1692245316320,1692245316727,1693217581114,499,407,92
404,1693217581114,1692245316830,1692245317201,1693217581618,504,371,133
405,1693217581618,1692245317312,1692245317689,1693217582132,514,377,137
406,1693217582132,1692245317872,1692245318091,1693217582580,448,219,229
407,1693217582580,1692245318283,1692245318695,1693217583131,551,412,139
408,1693217583131,1692245318875,1692245319163,1693217583590,459,288,171
409,1693217583590,1692245319378,1692245319603,1693217584006,416,225,191
410,1693217584006,1692245319733,1692245320043,1693217584451,445,310,135
411,1693217584452,1692245320141,1692245320325,1693217584681,229,184,45
412,1693217584681,1692245320380,1692245320809,1693217585197,516,429,87
413,1693217585197,1692245320922,1692245321144,1693217585638,441,222,219
414,1693217585638,1692245321344,1692245321755,1693217586168,530,411,119
415,1693217586168,1692245321901,1692245322221,1693217586614,446,320,126
416,1693217586614,1692245322333,1692245322743,1693217587153,539,410,129
417,1693217587153,1692245322860,1692245323170,1693217587589,436,310,126
418,1693217587589,1692245323301,1692245323612,1693217588010,421,311,110
419,1693217588010,1692245323737,1692245324021,1693217588427,417,284,133
420,1693217588427,1692245324141,1692245324452,1693217588853,426,311,115
421,1693217588853,1692245324563,1692245324915,1693217589353,500,352,148
422,1693217589353,1692245325082,1692245325436,1693217589809,456,354,102
423,1693217589809,1692245325525,1692245325825,1693217590216,407,300,107
424,1693217590216,1692245325934,1692245326234,1693217590671,455,300,155
425,1693217590671,1692245326406,1692245326771,1693217591262,591,365,226
426,1693217591262,1692245326964,1692245327306,1693217591741,479,342,137
427,1693217591741,1692245327457,1692245327782,1693217592222,481,325,156
428,1693217592222,1692245327946,1692245328281,1693217592670,448,335,113
429,1693217592670,1692245328432,1692245328690,1693217593100,430,258,172
430,1693217593100,1692245328819,1692245329068,1693217593482,382,249,133
431,1693217593482,1692245329203,1692245329528,1693217593918,436,325,111
432,1693217593918,1692245329651,1692245329955,1693217594601,683,304,379
433,1693217594601,1692245330359,1692245330643,1693217595066,465,284,181
434,1693217595066,1692245330760,1692245331093,1693217595501,435,333,102
435,1693217595501,1692245331221,1692245331649,1693217596051,550,428,122
436,1693217596051,1692245331776,1692245332131,1693217596519,468,355,113
437,1693217596519,1692245332229,1692245332533,1693217596951,432,304,128
438,1693217596951,1692245332653,1692245332894,1693217597341,390,241,149
439,1693217597341,1692245333035,1692245333376,1693217597752,411,341,70
440,1693217597930,1692245333648,1692245334210,1693217598613,683,562,121
441,1693217598613,1692245334312,1692245334868,1693217599397,784,556,228
442,1693217599397,1692245335116,1692245335438,1693217599853,456,322,134
443,1693217599853,1692245335549,1692245335993,1693217600397,544,444,100
444,1693217600397,1692245336102,1692245336451,1693217600848,451,349,102
445,1693217600848,1692245336558,1692245336850,1693217601326,478,292,186
446,1693217601326,1692245337042,1692245337274,1693217601697,371,232,139
447,1693217601697,1692245337441,1692245337810,1693217602217,520,369,151
448,1693217602217,1692245337949,1692245338266,1693217602708,491,317,174
449,1693217602708,1692245338503,1692245338725,1693217603139,431,222,209
450,1693217603139,1692245338837,1692245339129,1693217603539,400,292,108
451,1693217603539,1692245339255,1692245339563,1693217603964,425,308,117
452,1693217603964,1692245339675,1692245340034,1693217604498,534,359,175
453,1693217604498,1692245340218,1692245340616,1693217605075,577,398,179
454,1693217605075,1692245340776,1692245341161,1693217605597,522,385,137
455,1693217605597,1692245341296,1692245341598,1693217605991,394,302,92
456,1693217605991,1692245341687,1692245342055,1693217606494,503,368,135
457,1693217606494,1692245342213,1692245342550,1693217606962,468,337,131
458,1693217606962,1692245342672,1692245343024,1693217607417,455,352,103
459,1693217607417,1692245343121,1692245343475,1693217607868,451,354,97
460,1693217607868,1692245343570,1692245343989,1693217608378,510,419,91
461,1693217608378,1692245344129,1692245344320,1693217608742,364,191,173
462,1693217608742,1692245344458,1692245344743,1693217609131,389,285,104
463,1693217609131,1692245344871,1692245345155,1693217609563,432,284,148
464,1693217609563,1692245345260,1692245345608,1693217610093,530,348,182
465,1693217610093,1692245345812,1692245346171,1693217610574,481,359,122
466,1693217610574,1692245346302,1692245346590,1693217610974,400,288,112
467,1693217610974,1692245346704,1692245347126,1693217611586,612,422,190
468,1693217611587,1692245347339,1692245347679,1693217612078,491,340,151
469,1693217612078,1692245347797,1692245348091,1693217612541,463,294,169
470,1693217612541,1692245348239,1692245348517,1693217612977,436,278,158
471,1693217612977,1692245348699,1692245349046,1693217613471,494,347,147
472,1693217613472,1692245349176,1692245349453,1693217613923,451,277,174
473,1693217613923,1692245349661,1692245350093,1693217614483,560,432,128
474,1693217614484,1692245350186,1692245350595,1693217615100,616,409,207
475,1693217615100,1692245350809,1692245351120,1693217615537,437,311,126
476,1693217615537,1692245351251,1692245351643,1693217616041,504,392,112
477,1693217616041,1692245351757,1692245352035,1693217616471,430,278,152
478,1693217616471,1692245352218,1692245352603,1693217617057,586,385,201
479,1693217617057,1692245352772,1692245352978,1693217617402,345,206,139
480,1693217617402,1692245353168,1692245353443,1693217617936,534,275,259
481,1693217617936,1692245353684,1692245354013,1693217618408,472,329,143
482,1693217618408,1692245354105,1692245354376,1693217618793,385,271,114
483,1693217618793,1692245354524,1692245354828,1693217619244,451,304,147
484,1693217619244,1692245354960,1692245355259,1693217619848,604,299,305
485,1693217619848,1692245355562,1692245355926,1693217620350,502,364,138
486,1693217620350,1692245356067,1692245356463,1693217620937,587,396,191
487,1693217620938,1692245356645,1692245357009,1693217621415,477,364,113
488,1693217621415,1692245357120,1692245357503,1693217621985,570,383,187
489,1693217621985,1692245357722,1692245358003,1693217622409,424,281,143
490,1693217622409,1692245358125,1692245358362,1693217622810,401,237,164
491,1693217622810,1692245358518,1692245358836,1693217623215,405,318,87
492,1693217623215,1692245358927,1692245359249,1693217623640,425,322,103
493,1693217623640,1692245359354,1692245359682,1693217624083,443,328,115
494,1693217624083,1692245359783,1692245360018,1693217624474,391,235,156
495,1693217624474,1692245360218,1692245360629,1693217625014,540,411,129
496,1693217625014,1692245360730,1692245361107,1693217625496,482,377,105
497,1693217625496,1692245361219,1692245361474,1693217625984,488,255,233
498,1693217625984,1692245361677,1692245361961,1693217626331,347,284,63
499,1693217626331,1692245362037,1692245362455,1693217626868,537,418,119
500,1693217626868,1692245362581,1692245362932,1693217627329,461,351,110
501,1693217627329,1692245363033,1692245363300,1693217627684,355,267,88
502,1693217627684,1692245363379,1692245363791,1693217628214,530,412,118
503,1693217634252,1692245369939,1692245370274,1693217634663,411,335,76
504,1693217634663,1692245370388,1692245370693,1693217635105,442,305,137
505,1693217635105,1692245370831,1692245371136,1693217635536,431,305,126
506,1693217635536,1692245371260,1692245371510,1693217636015,479,250,229
507,1693217636015,1692245371712,1692245371935,1693217636324,309,223,86
508,1693217636325,1692245372022,1692245372285,1693217636685,360,263,97
509,1693217636685,1692245372443,1692245372643,1693217637144,459,200,259
510,1693217637144,1692245372838,1692245373194,1693217637570,426,356,70
511,1693217637570,1692245373286,1692245373658,1693217638064,494,372,122
512,1693217638064,1692245373767,1692245374056,1693217638453,389,289,100
513,1693217638453,1692245374167,1692245374532,1693217638925,472,365,107
514,1693217638925,1692245374627,1692245375016,1693217639403,478,389,89
515,1693217639403,1692245375094,1692245375487,1693217639889,486,393,93
516,1693217639889,1692245375622,1692245375867,1693217640279,390,245,145
517,1693217640279,1692245375997,1692245376285,1693217640746,467,288,179
518,1693217640746,1692245376453,1692245376725,1693217641162,416,272,144
519,1693217641162,1692245376874,1692245377249,1693217641642,480,375,105
520,1693217641642,1692245377368,1692245377617,1693217642038,396,249,147
521,1693217642038,1692245377765,1692245378019,1693217642465,427,254,173
522,1693217642465,1692245378170,1692245378595,1693217643011,546,425,121
523,1693217643011,1692245378720,1692245379115,1693217643496,485,395,90
524,1693217643496,1692245379209,1692245379458,1693217643895,399,249,150
525,1693217643895,1692245379605,1692245379857,1693217644368,473,252,221
526,1693217644368,1692245380080,1692245380348,1693217644745,377,268,109
527,1693217644745,1692245380463,1692245380734,1693217645231,486,271,215
528,1693217645231,1692245380945,1692245381217,1693217645622,391,272,119
529,1693217645622,1692245381320,1692245381625,1693217646027,405,305,100
530,1693217646028,1692245381743,1692245382058,1693217646453,425,315,110
531,1693217646453,1692245382145,1692245382586,1693217646964,511,441,70
532,1693217646964,1692245382694,1692245382915,1693217647332,368,221,147
533,1693217647332,1692245383105,1692245383404,1693217647805,473,299,174
534,1693217647805,1692245383514,1692245383822,1693217648215,410,308,102
535,1693217648215,1692245383923,1692245384311,1693217648725,510,388,122
536,1693217648725,1692245384469,1692245384797,1693217649206,481,328,153
537,1693217649206,1692245384906,1692245385310,1693217649692,486,404,82
538,1693217649692,1692245385394,1692245385787,1693217650191,499,393,106
539,1693217650191,1692245385900,1692245386245,1693217650639,448,345,103
540,1693217650639,1692245386349,1692245386581,1693217651073,434,232,202
541,1693217651073,1692245386782,1692245387163,1693217651554,481,381,100
542,1693217651554,1692245387244,1692245387589,1693217651973,419,345,74
543,1693217651973,1692245387688,1692245388003,1693217652428,455,315,140
544,1693217652428,1692245388185,1692245388497,1693217652978,550,312,238
545,1693217652978,1692245388661,1692245388947,1693217653380,402,286,116
546,1693217653380,1692245389125,1692245389418,1693217653805,425,293,132
547,1693217653805,1692245389523,1692245389764,1693217654239,434,241,193
548,1693217654239,1692245389942,1692245390356,1693217654737,498,414,84
549,1693217654737,1692245390426,1692245390639,1693217655036,299,213,86
550,1693217655036,1692245390834,1692245391175,1693217655583,547,341,206
551,1693217655583,1692245391329,1692245391565,1693217656011,428,236,192
552,1693217656011,1692245391713,1692245392032,1693217656404,393,319,74
553,1693217656404,1692245392116,1692245392387,1693217656844,440,271,169
554,1693217656844,1692245392566,1692245392901,1693217657327,483,335,148
555,1693217657327,1692245393031,1692245393392,1693217657795,468,361,107
556,1693217657795,1692245393508,1692245393836,1693217658257,462,328,134
557,1693217658257,1692245393993,1692245394439,1693217658811,554,446,108
558,1693217658811,1692245394517,1692245394869,1693217659271,460,352,108
559,1693217659272,1692245395013,1692245395325,1693217659728,456,312,144
560,1693217659728,1692245395463,1692245395735,1693217660154,426,272,154
561,1693217660154,1692245395880,1692245396150,1693217660557,403,270,133
562,1693217660557,1692245396316,1692245396676,1693217661124,567,360,207
563,1693217661124,1692245396850,1692245397217,1693217661657,533,367,166
564,1693217661657,1692245397375,1692245397717,1693217662125,468,342,126
565,1693217662125,1692245397844,1692245398208,1693217662614,489,364,125
566,1693217662614,1692245398330,1692245398657,1693217663055,441,327,114
567,1693217663055,1692245398775,1692245399134,1693217663537,482,359,123
568,1693217663537,1692245399236,1692245399682,1693217664116,579,446,133
569,1693217664116,1692245399821,1692245400121,1693217664494,378,300,78
570,1693217664669,1692245400383,1692245400731,1693217665206,537,348,189
571,1693217665206,1692245400968,1692245401589,1693217666003,797,621,176
572,1693217666003,1692245401719,1692245402126,1693217666535,532,407,125
573,1693217666535,1692245402244,1692245402558,1693217666943,408,314,94
574,1693217666943,1692245402660,1692245402942,1693217667367,424,282,142
575,1693217667367,1692245403088,1692245403346,1693217667835,468,258,210
576,1693217667835,1692245403630,1692245403868,1693217668324,489,238,251
577,1693217668324,1692245404063,1692245404408,1693217668902,578,345,233
578,1693217668902,1692245404644,1692245405083,1693217669471,569,439,130
579,1693217669471,1692245405182,1692245405479,1693217669894,423,297,126
580,1693217669894,1692245405621,1692245406001,1693217670398,504,380,124
581,1693217670398,1692245406101,1692245406462,1693217670850,452,361,91
582,1693217670850,1692245406563,1692245406891,1693217671290,440,328,112
583,1693217671290,1692245407011,1692245407228,1693217671665,375,217,158
584,1693217671665,1692245407425,1692245407668,1693217672216,551,243,308
585,1693217672216,1692245407921,1692245408311,1693217672743,527,390,137
586,1693217672743,1692245408449,1692245408799,1693217673257,514,350,164
587,1693217673257,1692245408982,1692245409364,1693217673780,523,382,141
588,1693217673780,1692245409494,1692245409839,1693217674221,441,345,96
589,1693217674221,1692245409924,1692245410260,1693217674651,430,336,94
590,1693217674651,1692245410362,1692245410782,1693217675172,521,420,101
591,1693217675172,1692245410873,1692245411233,1693217675627,455,360,95
592,1693217675627,1692245411341,1692245411656,1693217676061,434,315,119
593,1693217676061,1692245411773,1692245412081,1693217676461,400,308,92
594,1693217676461,1692245412186,1692245412508,1693217676953,492,322,170
595,1693217676953,1692245412674,1692245412921,1693217677416,463,247,216
596,1693217677416,1692245413133,1692245413344,1693217677805,389,211,178
597,1693217677805,1692245413524,1692245413873,1693217678263,458,349,109
598,1693217678263,1692245413962,1692245414301,1693217678686,423,339,84
599,1693217678687,1692245414389,1692245414692,1693217679112,425,303,122
600,1693217679112,1692245414824,1692245415205,1693217679728,616,381,235
601,1693217679728,1692245415445,1692245415787,1693217680197,469,342,127
602,1693217680197,1692245415899,1692245416175,1693217680575,378,276,102
603,1693217680575,1692245416292,1692245416595,1693217681023,448,303,145
604,1693217681023,1692245416731,1692245417090,1693217681497,474,359,115
605,1693217681497,1692245417214,1692245417646,1693217682023,526,432,94
606,1693217682023,1692245417755,1692245418056,1693217682462,439,301,138
607,1693217682462,1692245418160,1692245418528,1693217682987,525,368,157
608,1693217682987,1692245418692,1692245419052,1693217683439,452,360,92
609,1693217683439,1692245419146,1692245419560,1693217684003,564,414,150
610,1693217684003,1692245419711,1692245420056,1693217684578,575,345,230
611,1693217684578,1692245420277,1692245420624,1693217685034,456,347,109
612,1693217685034,1692245420766,1692245421002,1693217685447,413,236,177
613,1693217685447,1692245421151,1692245421474,1693217685900,453,323,130
614,1693217685900,1692245421607,1692245421857,1693217686220,320,250,70
615,1693217686220,1692245421938,1692245422258,1693217686671,451,320,131
616,1693217686671,1692245422398,1692245422737,1693217687135,464,339,125
617,1693217687135,1692245422908,1692245423143,1693217687544,409,235,174
618,1693217687544,1692245423245,1692245423625,1693217688013,469,380,89
619,1693217688013,1692245423712,1692245424079,1693217688465,452,367,85
620,1693217688465,1692245424178,1692245424542,1693217689035,570,364,206
621,1693217689036,1692245424741,1692245425096,1693217689524,488,355,133
622,1693217689524,1692245425237,1692245425484,1693217689969,445,247,198
623,1693217689969,1692245425670,1692245426072,1693217690463,494,402,92
624,1693217690463,1692245426168,1692245426405,1693217690896,433,237,196
625,1693217690896,1692245426597,1692245426868,1693217691277,381,271,110
626,1693217691277,1692245426973,1692245427401,1693217691786,509,428,81
627,1693217691787,1692245427506,1692245427729,1693217692176,389,223,166
628,1693217692176,1692245427926,1692245428196,1693217692608,432,270,162
629,1693217692608,1692245428331,1692245428658,1693217693119,511,327,184
630,1693217693119,1692245428830,1692245429147,1693217693527,408,317,91
631,1693217693527,1692245429248,1692245429519,1693217693980,453,271,182
632,1693217693980,1692245429704,1692245430022,1693217694466,486,318,168
633,1693217694466,1692245430232,1692245430503,1693217694935,469,271,198
634,1693217697956,1692245433670,1692245434103,1693217698592,636,433,203
635,1693217698592,1692245434326,1692245434606,1693217699098,506,280,226
636,1693217699098,1692245434814,1692245435190,1693217699591,493,376,117
637,1693217699591,1692245435299,1692245435639,1693217700089,498,340,158
638,1693217700089,1692245435814,1692245436083,1693217700473,384,269,115
639,1693217700473,1692245436180,1692245436554,1693217701020,547,374,173
640,1693217701020,1692245436720,1692245437032,1693217701469,449,312,137
641,1693217701469,1692245437187,1692245437485,1693217701870,401,298,103
642,1693217701870,1692245437589,1692245437934,1693217702327,457,345,112
643,1693217702327,1692245438032,1692245438385,1693217702781,454,353,101
644,1693217702781,1692245438506,1692245438765,1693217703180,399,259,140
645,1693217703180,1692245438870,1692245439149,1693217703520,340,279,61
646,1693217703520,1692245439227,1692245439649,1693217704094,574,422,152
647,1693217704094,1692245439805,1692245440071,1693217704487,393,266,127
648,1693217704487,1692245440196,1692245440495,1693217704906,419,299,120
649,1693217704906,1692245440604,1692245440897,1693217705342,436,293,143
650,1693217705342,1692245441052,1692245441458,1693217705836,494,406,88
651,1693217705836,1692245441521,1692245441729,1693217706084,248,208,40
652,1693217706084,1692245441813,1692245442042,1693217706500,416,229,187
653,1693217706500,1692245442240,1692245442469,1693217706891,391,229,162
654,1693217706891,1692245442613,1692245442869,1693217707276,385,256,129
655,1693217707276,1692245443008,1692245443226,1693217707652,376,218,158
656,1693217707652,1692245443374,1692245443630,1693217708098,446,256,190
657,1693217708098,1692245443793,1692245444129,1693217708521,423,336,87
658,1693217708521,1692245444236,1692245444520,1693217709153,632,284,348
659,1693217709153,1692245444856,1692245445248,1693217709625,472,392,80
660,1693217709625,1692245445333,1692245445714,1693217710113,488,381,107
661,1693217710113,1692245445831,1692245446134,1693217710557,444,303,141
662,1693217710557,1692245446297,1692245446644,1693217711050,493,347,146
663,1693217711050,1692245446772,1692245447106,1693217711507,457,334,123
664,1693217711508,1692245447218,1692245447640,1693217712023,515,422,93
665,1693217712023,1692245447743,1692245448057,1693217712449,426,314,112
666,1693217712449,1692245448157,1692245448509,1693217712963,514,352,162
667,1693217712963,1692245448682,1692245449031,1693217713419,456,349,107
668,1693217713419,1692245449120,1692245449373,1693217713819,400,253,147
669,1693217713819,1692245449569,1692245449808,1693217714217,398,239,159
670,1693217714217,1692245449933,1692245450278,1693217714680,463,345,118
671,1693217714680,1692245450395,1692245450777,1693217715189,509,382,127
672,1693217715189,1692245450899,1692245451281,1693217715688,499,382,117
673,1693217715688,1692245451468,1692245451683,1693217716121,433,215,218
674,1693217716121,1692245451827,1692245451972,1693217716325,204,145,59
675,1693217716325,1692245452037,1692245452298,1693217716736,411,261,150
676,1693217716736,1692245452481,1692245452771,1693217717227,491,290,201
677,1693217717227,1692245452996,1692245453305,1693217717714,487,309,178
678,1693217717714,1692245453411,1692245453795,1693217718189,475,384,91
679,1693217718189,1692245453901,1692245454216,1693217718613,424,315,109
680,1693217718613,1692245454336,1692245454654,1693217719059,446,318,128
681,1693217719059,1692245454773,1692245455113,1693217719501,442,340,102
682,1693217719501,1692245455255,1692245455511,1693217719919,418,256,162
683,1693217719920,1692245455630,1692245455996,1693217720486,566,366,200
684,1693217720486,1692245456196,1692245456435,1693217720828,342,239,103
685,1693217720828,1692245456533,1692245456868,1693217721292,464,335,129
686,1693217721292,1692245457009,1692245457298,1693217721703,411,289,122
687,1693217721703,1692245457425,1692245457678,1693217722126,423,253,170
688,1693217722126,1692245457826,1692245458234,1693217722620,494,408,86
689,1693217722620,1692245458335,1692245458638,1693217723039,419,303,116
690,1693217723039,1692245458755,1692245459037,1693217723433,394,282,112
691,1693217723433,1692245459136,1692245459364,1693217723793,360,228,132
692,1693217723793,1692245459520,1692245459913,1693217724325,532,393,139
693,1693217724325,1692245460028,1692245460447,1693217724877,552,419,133
694,1693217724877,1692245460610,1692245460876,1693217725334,457,266,191
695,1693217725334,1692245461068,1692245461304,1693217725727,393,236,157
696,1693217725727,1692245461436,1692245461778,1693217726188,461,342,119
697,1693217726188,1692245461897,1692245462163,1693217726545,357,266,91
698,1693217726545,1692245462245,1692245462634,1693217727060,515,389,126
699,1693217727060,1692245462768,1692245463043,1693217727412,352,275,77
700,1693217727412,1692245463110,1692245463431,1693217727830,418,321,97
701,1693217727830,1692245463523,1692245463913,1693217728285,455,390,65
702,1693217728470,1692245464200,1692245464908,1693217729333,863,708,155
703,1693217729333,1692245465104,1692245465509,1693217729927,594,405,189
704,1693217729927,1692245465666,1692245466067,1693217730488,561,401,160
705,1693217730488,1692245466223,1692245466420,1693217730923,435,197,238
706,1693217730923,1692245466672,1692245466895,1693217731377,454,223,231
707,1693217731377,1692245467102,1692245467387,1693217731908,531,285,246
708,1693217731908,1692245467613,1692245467917,1693217732393,485,304,181
709,1693217732393,1692245468141,1692245468409,1693217732903,510,268,242
710,1693217732903,1692245468621,1692245469008,1693217733414,511,387,124
711,1693217733414,1692245469127,1692245469464,1693217733885,471,337,134
712,1693217733885,1692245469599,1692245470005,1693217734385,500,406,94
713,1693217734385,1692245470100,1692245470422,1693217734827,442,322,120
714,1693217734827,1692245470527,1692245470880,1693217735272,445,353,92
715,1693217735272,1692245471001,1692245471299,1693217735728,456,298,158
716,1693217735728,1692245471445,1692245471832,1693217736264,536,387,149
717,1693217736264,1692245471990,1692245472372,1693217736788,524,382,142
718,1693217736788,1692245472559,1692245472924,1693217737346,558,365,193
719,1693217737346,1692245473052,1692245473405,1693217737783,437,353,84
720,1693217737783,1692245473515,1692245473734,1693217738228,445,219,226
721,1693217738228,1692245473976,1692245474354,1693217738784,556,378,178
722,1693217738784,1692245474503,1692245474819,1693217739241,457,316,141
723,1693217739241,1692245474988,1692245475242,1693217739648,407,254,153
724,1693217739648,1692245475411,1692245475613,1693217740136,488,202,286
725,1693217740136,1692245475894,1692245476138,1693217740550,414,244,170
726,1693217740550,1692245476337,1692245476658,1693217741070,520,321,199
727,1693217741070,1692245476806,1692245477176,1693217741599,529,370,159
728,1693217741599,1692245477315,1692245477665,1693217742122,523,350,173
729,1693217742122,1692245477828,1692245478092,1693217742491,369,264,105
730,1693217742491,1692245478205,1692245478570,1693217743031,540,365,175
731,1693217743031,1692245478724,1692245479070,1693217743484,453,346,107
732,1693217743484,1692245479184,1692245479570,1693217744041,557,386,171
733,1693217744041,1692245479762,1692245480144,1693217744639,598,382,216
734,1693217744639,1692245480383,1692245480589,1693217745040,401,206,195
735,1693217745040,1692245480750,1692245481130,1693217745551,511,380,131
736,1693217745551,1692245481272,1692245481598,1693217746094,543,326,217
737,1693217746094,1692245481817,1692245482115,1693217746523,429,298,131
738,1693217746523,1692245482240,1692245482603,1693217747008,485,363,122
739,1693217747008,1692245482719,1692245483085,1693217747472,464,366,98
740,1693217747472,1692245483212,1692245483525,1693217747925,453,313,140
741,1693217747925,1692245483624,1692245484016,1693217748418,493,392,101
742,1693217748418,1692245484133,1692245484518,1693217748913,495,385,110
743,1693217748913,1692245484608,1692245484927,1693217749314,401,319,82
744,1693217749314,1692245485025,1692245485357,1693217749780,466,332,134
745,1693217749780,1692245485496,1692245485809,1693217750206,426,313,113
746,1693217750206,1692245485941,1692245486264,1693217750663,457,323,134
747,1693217750663,1692245486368,1692245486713,1693217751127,464,345,119
748,1693217751127,1692245486829,1692245487195,1693217751647,520,366,154
749,1693217751647,1692245487367,1692245487615,1693217752016,369,248,121
750,1693217752016,1692245487731,1692245488040,1693217752470,454,309,145
751,1693217752470,1692245488183,1692245488572,1693217752946,476,389,87
752,1693217752946,1692245488659,1692245488927,1693217753316,370,268,102
753,1693217753316,1692245489024,1692245489369,1693217753770,454,345,109
754,1693217753770,1692245489504,1692245489721,1693217754143,373,217,156
755,1693217754143,1692245489838,1692245490213,1693217754593,450,375,75
756,1693217754593,1692245490310,1692245490628,1693217755050,457,318,139
757,1693217755050,1692245490754,1692245491130,1693217755517,467,376,91
758,1693217755517,1692245491231,1692245491554,1693217755934,417,323,94
759,1693217755934,1692245491644,1692245492007,1693217756428,494,363,131
760,1693217756428,1692245492167,1692245492557,1693217756946,518,390,128
761,1693217756946,1692245492639,1692245493046,1693217757442,496,407,89
762,1693217757442,1692245493160,1692245493378,1693217757827,385,218,167
763,1693217757827,1692245493541,1692245493902,1693217758307,480,361,119
764,1693217758307,1692245494024,1692245494281,1693217758734,427,257,170
765,1693217761764,1692245497466,1692245497870,1693217762343,579,404,175
766,1693217762344,1692245498069,1692245498381,1693217762780,436,312,124
767,1693217762780,1692245498524,1692245498724,1693217763191,411,200,211
768,1693217763191,1692245498897,1692245499255,1693217763682,491,358,133
769,1693217763682,1692245499391,1692245499679,1693217764153,471,288,183
770,1693217764153,1692245499864,1692245500149,1693217764536,383,285,98
771,1693217764536,1692245500265,1692245500522,1693217764921,385,257,128
772,1693217764921,1692245500630,1692245500907,1693217765357,436,277,159
773,1693217765357,1692245501102,1692245501396,1693217765847,490,294,196
774,1693217765847,1692245501577,1692245501812,1693217766208,361,235,126
775,1693217766208,1692245501922,1692245502246,1693217766652,444,324,120
776,1693217766652,1692245502375,1692245502654,1693217767093,441,279,162
777,1693217767093,1692245502813,1692245503183,1693217767578,485,370,115
778,1693217767578,1692245503301,1692245503575,1693217767980,402,274,128
779,1693217767980,1692245503695,1692245503971,1693217768412,432,276,156
780,1693217768412,1692245504150,1692245504356,1693217768737,325,206,119
781,1693217768737,1692245504455,1692245504884,1693217769321,584,429,155
782,1693217769321,1692245505020,1692245505318,1693217769689,368,298,70
783,1693217769689,1692245505385,1692245505747,1693217770167,478,362,116
784,1693217770167,1692245505928,1692245506248,1693217770704,537,320,217
785,1693217770704,1692245506415,1692245506815,1693217771250,546,400,146
786,1693217771250,1692245506986,1692245507297,1693217771688,438,311,127
787,1693217771688,1692245507390,1692245507651,1693217772048,360,261,99
788,1693217772048,1692245507756,1692245507992,1693217772397,349,236,113
789,1693217772397,1692245508122,1692245508420,1693217772838,441,298,143
790,1693217772838,1692245508546,1692245508944,1693217773407,569,398,171
791,1693217773407,1692245509122,1692245509360,1693217773783,376,238,138
792,1693217773783,1692245509511,1692245509863,1693217774246,463,352,111
793,1693217774246,1692245509956,1692245510263,1693217774842,596,307,289
794,1693217774842,1692245510561,1692245510856,1693217775284,442,295,147
795,1693217775284,1692245510974,1692245511265,1693217775640,356,291,65
796,1693217775640,1692245511365,1692245511610,1693217776013,373,245,128
797,1693217776013,1692245511762,1692245512019,1693217776452,439,257,182
798,1693217776452,1692245512157,1692245512418,1693217776806,354,261,93
799,1693217776806,1692245512516,1692245512817,1693217777305,499,301,198
800,1693217777305,1692245513038,1692245513326,1693217777789,484,288,196
801,1693217777789,1692245513498,1692245513822,1693217778229,440,324,116
802,1693217778229,1692245513945,1692245514226,1693217778677,448,281,167
803,1693217778677,1692245514421,1692245514668,1693217779172,495,247,248
804,1693217779172,1692245514876,1692245515236,1693217779695,523,360,163
805,1693217779695,1692245515451,1692245515846,1693217780274,579,395,184
806,1693217780274,1692245515973,1692245516328,1693217780707,433,355,78
807,1693217780707,1692245516405,1692245516699,1693217781133,426,294,132
808,1693217781133,1692245516848,1692245517158,1693217781563,430,310,120
809,1693217781563,1692245517271,1692245517644,1693217782062,499,373,126
810,1693217782062,1692245517823,1692245518128,1693217782594,532,305,227
811,1693217782594,1692245518309,1692245518625,1693217783044,450,316,134
812,1693217783044,1692245518747,1692245519154,1693217783536,492,407,85
813,1693217783536,1692245519247,1692245519539,1693217783962,426,292,134
814,1693217783962,1692245519675,1692245519967,1693217784380,418,292,126
815,1693217784380,1692245520078,1692245520502,1693217784896,516,424,92
816,1693217784896,1692245520695,1692245520959,1693217785384,488,264,224
817,1693217785384,1692245521088,1692245521466,1693217785912,528,378,150
818,1693217785912,1692245521625,1692245521955,1693217786342,430,330,100
819,1693217786342,1692245522104,1692245522479,1693217786898,556,375,181
820,1693217786898,1692245522616,1692245523051,1693217787433,535,435,100
821,1693217787433,1692245523147,1692245523472,1693217787961,528,325,203
822,1693217787961,1692245523684,1692245524019,1693217788425,464,335,129
823,1693217788426,1692245524132,1692245524389,1693217788788,362,257,105
824,1693217788788,1692245524492,1692245524924,1693217789308,520,432,88
825,1693217789308,1692245525038,1692245525503,1693217789907,599,465,134
826,1693217789907,1692245525618,1692245525938,1693217790369,462,320,142
827,1693217790369,1692245526099,1692245526469,1693217790890,521,370,151
828,1693217790890,1692245526603,1692245526878,1693217791245,355,275,80
829,1693217791245,1692245526952,1692245527319,1693217791759,514,367,147
830,1693217791759,1692245527457,1692245527686,1693217792088,329,229,100
831,1693217792263,1692245528024,1692245528392,1693217792912,649,368,281
832,1693217792912,1692245528618,1692245529120,1693217793520,608,502,106
833,1693217793520,1692245529264,1692245529618,1693217794130,610,354,256
834,1693217794130,1692245529855,1692245530175,1693217794597,467,320,147
835,1693217794597,1692245530362,1692245530627,1693217795046,449,265,184
836,1693217795046,1692245530815,1692245531061,1693217795463,417,246,171
837,1693217795463,1692245531192,1692245531563,1693217795961,498,371,127
838,1693217795961,1692245531674,1692245532075,1693217796463,502,401,101
839,1693217796463,1692245532174,1692245532371,1693217796853,390,197,193
840,1693217796853,1692245532573,1692245532953,1693217797354,501,380,121
841,1693217797354,1692245533077,1692245533322,1693217797723,369,245,124
842,1693217797723,1692245533439,1692245533827,1693217798208,485,388,97
843,1693217798208,1692245533905,1692245534280,1693217798666,458,375,83
844,1693217798666,1692245534362,1692245534700,1693217799106,440,338,102
845,1693217799106,1692245534817,1692245535077,1693217799464,358,260,98
846,1693217799464,1692245535187,1692245535455,1693217799865,401,268,133
847,1693217799865,1692245535576,1692245535896,1693217800335,470,320,150
848,1693217800335,1692245536063,1692245536380,1693217800965,630,317,313
849,1693217800965,1692245536677,1692245537013,1693217801411,446,336,110
850,1693217801411,1692245537124,1692245537460,1693217801859,448,336,112
851,1693217801859,1692245537566,1692245537888,1693217802284,425,322,103
852,1693217802284,1692245538006,1692245538244,1693217802657,373,238,135
853,1693217802657,1692245538359,1692245538630,1693217803086,429,271,158
854,1693217803086,1692245538813,1692245539101,1693217803495,409,288,121
855,1693217803495,1692245539237,1692245539477,1693217803932,437,240,197
856,1693217803933,1692245539681,1692245539889,1693217804361,428,208,220
857,1693217804361,1692245540326,1692245540634,1693217805078,717,308,409
858,1693217805078,1692245540804,1692245541100,1693217805515,437,296,141
859,1693217805515,1692245541247,1692245541601,1693217805991,476,354,122
860,1693217805992,1692245541708,1692245542064,1693217806458,466,356,110
861,1693217806458,1692245542170,1692245542411,1693217806937,479,241,238
862,1693217806937,1692245542634,1692245542941,1693217807360,423,307,116
863,1693217807360,1692245543102,1692245543337,1693217807837,477,235,242
864,1693217807837,1692245543552,1692245543968,1693217808355,518,416,102
865,1693217808355,1692245544072,1692245544417,1693217808847,492,345,147
866,1693217808847,1692245544562,1692245544856,1693217809272,425,294,131
867,1693217809272,1692245544978,1692245545360,1693217809772,500,382,118
868,1693217809772,1692245545479,1692245545733,1693217810118,346,254,92
869,1693217810118,1692245545885,1692245546201,1693217810600,482,316,166
870,1693217810600,1692245546314,1692245546566,1693217810998,398,252,146
871,1693217810998,1692245546728,1692245547051,1693217811477,479,323,156
872,1693217811477,1692245547188,1692245547485,1693217811889,412,297,115
873,1693217811889,1692245547607,1692245547999,1693217812409,520,392,128
874,1693217812409,1692245548106,1692245548475,1693217812867,458,369,89
875,1693217812867,1692245548589,1692245548906,1693217813301,434,317,117
876,1693217813301,1692245549018,1692245549347,1693217813780,479,329,150
877,1693217813780,1692245549488,1692245549857,1693217814247,467,369,98
878,1693217814247,1692245549955,1692245550348,1693217814808,561,393,168
879,1693217814808,1692245550537,1692245550877,1693217815303,495,340,155
880,1693217815303,1692245551017,1692245551404,1693217815797,494,387,107
881,1693217815797,1692245551519,1692245551829,1693217816237,440,310,130
882,1693217816237,1692245551946,1692245552274,1693217816659,422,328,94
883,1693217816659,1692245552366,1692245552609,1693217817036,377,243,134
884,1693217817036,1692245552771,1692245553066,1693217817561,525,295,230
885,1693217817561,1692245553259,1692245553634,1693217818012,451,375,76
886,1693217818012,1692245553720,1692245554069,1693217818469,457,349,108
887,1693217818469,1692245554192,1692245554441,1693217818907,438,249,189
888,1693217818907,1692245554622,1692245555057,1693217819493,586,435,151
889,1693217819493,1692245555195,1692245555630,1693217820011,518,435,83
890,1693217820011,1692245555712,1692245555986,1693217820377,366,274,92
891,1693217820377,1692245556082,1692245556387,1693217820795,418,305,113
892,1693217820795,1692245556526,1692245556872,1693217821340,545,346,199
893,1693217821340,1692245557053,1692245557327,1693217821726,386,274,112
894,1693217821726,1692245557451,1692245557771,1693217822175,449,320,129
895,1693217822175,1692245557900,1692245558328,1693217822756,581,428,153
896,1693217828791,1692245564500,1692245564790,1693217829229,438,290,148
897,1693217829229,1692245564950,1692245565268,1693217829671,442,318,124
898,1693217829672,1692245565387,1692245565794,1693217830180,508,407,101
899,1693217830180,1692245565878,1692245566266,1693217830656,476,388,88
900,1693217830656,1692245566373,1692245566634,1693217831081,425,261,164
901,1693217831081,1692245566797,1692245567147,1693217831588,507,350,157
902,1693217831588,1692245567317,1692245567557,1693217831961,373,240,133
903,1693217831961,1692245567674,1692245567972,1693217832390,429,298,131
904,1693217832390,1692245568119,1692245568331,1693217832857,467,212,255
905,1693217832857,1692245568578,1692245568929,1693217833343,486,351,135
906,1693217833343,1692245569047,1692245569328,1693217833722,379,281,98
907,1693217833722,1692245569436,1692245569757,1693217834241,519,321,198
908,1693217834241,1692245569968,1692245570320,1693217834814,573,352,221
909,1693217834814,1692245570508,1692245570848,1693217835211,397,340,57
910,1693217835211,1692245570918,1692245571232,1693217835621,410,314,96
911,1693217835621,1692245571326,1692245571678,1693217836090,469,352,117
912,1693217836090,1692245571795,1692245572058,1693217836421,331,263,68
913,1693217836421,1692245572136,1692245572550,1693217836977,556,414,142
914,1693217836977,1692245572712,1692245572991,1693217837404,427,279,148
915,1693217837404,1692245573132,1692245573425,1693217837830,426,293,133
916,1693217837830,1692245573562,1692245573783,1693217838225,395,221,174
917,1693217838225,1692245573938,1692245574359,1693217838740,515,421,94
918,1693217838740,1692245574475,1692245574709,1693217839127,387,234,153
919,1693217839127,1692245574838,1692245575185,1693217839690,563,347,216
920,1693217839690,1692245575372,1692245575783,1693217840165,475,411,64
921,1693217840165,1692245575890,1692245576223,1693217840610,445,333,112
922,1693217840610,1692245576318,1692245576700,1693217841090,480,382,98
923,1693217841090,1692245576810,1692245577118,1693217841515,425,308,117
924,1693217841515,1692245577214,1692245577550,1693217842016,501,336,165
925,1693217842016,1692245577725,1692245578070,1693217842540,524,345,179
926,1693217842540,1692245578250,1692245578534,1693217842937,397,284,113
927,1693217842937,1692245578654,1692245578917,1693217843331,394,263,131
928,1693217843331,1692245579037,1692245579394,1693217843785,454,357,97
929,1693217843785,1692245579507,1692245579876,1693217844272,487,369,118
930,1693217844272,1692245579985,1692245580290,1693217844666,394,305,89
931,1693217844666,1692245580393,1692245580750,1693217845172,506,357,149
932,1693217845172,1692245580894,1692245581152,1693217845567,395,258,137
933,1693217845567,1692245581296,1692245581565,1693217846028,461,269,192
934,1693217846028,1692245581748,1692245582053,1693217846429,401,305,96
935,1693217846429,1692245582145,1692245582439,1693217846938,509,294,215
936,1693217846938,1692245582669,1692245582891,1693217847323,385,222,163
937,1693217847323,1692245583042,1692245583392,1693217847887,564,350,214
938,1693217847887,1692245583625,1692245583866,1693217848294,407,241,166
939,1693217848294,1692245584054,1692245584272,1693217848685,391,218,173
940,1693217848685,1692245584397,1692245584798,1693217849202,517,401,116
941,1693217849202,1692245584908,1692245585172,1693217849550,348,264,84
942,1693217849550,1692245585251,1692245585550,1693217849947,397,299,98
943,1693217849947,1692245585662,1692245585999,1693217850399,452,337,115
944,1693217850399,1692245586100,1692245586482,1693217850918,519,382,137
945,1693217850918,1692245586643,1692245587014,1693217851411,493,371,122
946,1693217851411,1692245587121,1692245587459,1693217851862,451,338,113
947,1693217851862,1692245587566,1692245587978,1693217852371,509,412,97
948,1693217852371,1692245588083,1692245588401,1693217852873,502,318,184
949,1693217852873,1692245588590,1692245588882,1693217853391,518,292,226
950,1693217853391,1692245589119,1692245589336,1693217853744,353,217,136
951,1693217853744,1692245589462,1692245589768,1693217854200,456,306,150
952,1693217854200,1692245589903,1692245590292,1693217854686,486,389,97
953,1693217854686,1692245590409,1692245590777,1693217855168,482,368,114
954,1693217855168,1692245590894,1692245591291,1693217855673,505,397,108
955,1693217855673,1692245591432,1692245591737,1693217856113,440,305,135
956,1693217856113,1692245591820,1692245592119,1693217856491,378,299,79
957,1693217856491,1692245592229,1692245592478,1693217856890,399,249,150
958,1693217856890,1692245592603,1692245592949,1693217857362,472,346,126
959,1693217857362,1692245593094,1692245593429,1693217857832,470,335,135
960,1693217857832,1692245593542,1692245593880,1693217858297,465,338,127
961,1693217858297,1692245594003,1692245594280,1693217858648,351,277,74
962,1693217858648,1692245594361,1692245594697,1693217859098,450,336,114
963,1693217859273,1692245595021,1692245595605,1693217860010,737,584,153
964,1693217860010,1692245595755,1692245596168,1693217860589,579,413,166
965,1693217860589,1692245596310,1692245596732,1693217861139,550,422,128
966,1693217861139,1692245596853,1692245597219,1693217861609,470,366,104
967,1693217861609,1692245597317,1692245597558,1693217861958,349,241,108
968,1693217861958,1692245597675,1692245598013,1693217862410,452,338,114
969,1693217862410,1692245598130,1692245598435,1693217862875,465,305,160
970,1693217862875,1692245598573,1692245598880,1693217863308,433,307,126
971,1693217863308,1692245599023,1692245599418,1693217863858,550,395,155
972,1693217863858,1692245599559,1692245599967,1693217864354,496,408,88
973,1693217864354,1692245600086,1692245600310,1693217864872,518,224,294
974,1693217864872,1692245600594,1692245600976,1693217865410,538,382,156
975,1693217865410,1692245601140,1692245601358,1693217865909,499,218,281
976,1693217865909,1692245601628,1692245601946,1693217866355,446,318,128
977,1693217866355,1692245602084,1692245602300,1693217866715,360,216,144
978,1693217866715,1692245602454,1692245602688,1693217867158,443,234,209
979,1693217867158,1692245602869,1692245603285,1693217867671,513,416,97
980,1693217867671,1692245603422,1692245603772,1693217868170,499,350,149
981,1693217868170,1692245603882,1692245604176,1693217868562,392,294,98
982,1693217868562,1692245604264,1692245604618,1693217869053,491,354,137
983,1693217869053,1692245604758,1692245605124,1693217869515,462,366,96
984,1693217869515,1692245605228,1692245605505,1693217869910,395,277,118
985,1693217869910,1692245605646,1692245605880,1693217870287,377,234,143
986,1693217870287,1692245605998,1692245606217,1693217870656,369,219,150
987,1693217870656,1692245606409,1692245606646,1693217871063,407,237,170
988,1693217871063,1692245606775,1692245607140,1693217871542,479,365,114
989,1693217871542,1692245607263,1692245607571,1693217871964,422,308,114
990,1693217871964,1692245607683,1692245608012,1693217872419,455,329,126
991,1693217872419,1692245608133,1692245608530,1693217872992,573,397,176
992,1693217872992,1692245608750,1692245608985,1693217873400,408,235,173
993,1693217873400,1692245609126,1692245609428,1693217873836,436,302,134
994,1693217873836,1692245609564,1692245609874,1693217874288,452,310,142
995,1693217874288,1692245610007,1692245610270,1693217874734,446,263,183
996,1693217874734,1692245610455,1692245610710,1693217875111,377,255,122
997,1693217875111,1692245610936,1692245611229,1693217875637,526,293,233
998,1693217875637,1692245611385,1692245611734,1693217876139,502,349,153
999,1693217876139,1692245611847,1692245612100,1693217876498,359,253,106
1000,1693217876498,1692245612214,1692245612608,1693217877002,504,394,110
1001,1693217877002,1692245612757,1692245613061,1693217877456,454,304,150
1002,1693217877456,1692245613178,1692245613581,1693217877976,520,403,117
1003,1693217877976,1692245613678,1692245614063,1693217878453,477,385,92
1004,1693217878453,1692245614166,1692245614537,1693217878994,541,371,170
1005,1693217878994,1692245614691,1692245615109,1693217879518,524,418,106
1006,1693217879518,1692245615261,1692245615506,1693217879919,401,245,156
1007,1693217879919,1692245615633,1692245615832,1693217880314,395,199,196
1008,1693217880314,1692245616061,1692245616307,1693217880797,483,246,237
1009,1693217880797,1692245616500,1692245616836,1693217881225,428,336,92
1010,1693217881225,1692245616934,1692245617316,1693217881701,476,382,94
1011,1693217881701,1692245617408,1692245617764,1693217882154,453,356,97
1012,1693217882154,1692245617859,1692245618228,1693217882606,452,369,83
1013,1693217882606,1692245618296,1692245618617,1693217883042,436,321,115
1014,1693217883042,1692245618754,1692245619163,1693217883572,530,409,121
1015,1693217883572,1692245619293,1692245619578,1693217883945,373,285,88
1016,1693217883945,1692245619651,1692245620027,1693217884417,472,376,96
1017,1693217884417,1692245620118,1692245620526,1693217885012,595,408,187
1018,1693217885012,1692245620731,1692245621033,1693217885431,419,302,117
1019,1693217885431,1692245621142,1692245621489,1693217885879,448,347,101
1020,1693217885879,1692245621607,1692245622016,1693217886421,542,409,133
1021,1693217886421,1692245622129,1692245622505,1693217886916,495,376,119
1022,1693217886916,1692245622632,1692245622965,1693217887359,443,333,110
1023,1693217887359,1692245623082,1692245623397,1693217887829,470,315,155
1024,1693217887829,1692245623607,1692245623846,1693217888256,427,239,188
1025,1693217888256,1692245623979,1692245624365,1693217888759,503,386,117
1026,1693217888759,1692245624487,1692245624749,1693217889235,476,262,214
1027,1693217889235,1692245624949,1692245625188,1693217889671,436,239,197
1028,1693217892706,1692245628409,1692245628760,1693217893227,521,351,170
1029,1693217893227,1692245628936,1692245629281,1693217893737,510,345,165
1030,1693217893737,1692245629445,1692245629697,1693217894151,414,252,162
1031,1693217894151,1692245629873,1692245630181,1693217894675,524,308,216
1032,1693217894675,1692245630372,1692245630759,1693217895188,513,387,126
1033,1693217895188,1692245630891,1692245631290,1693217895834,646,399,247
1034,1693217895834,1692245631580,1692245631874,1693217896509,675,294,381
1035,1693217896509,1692245632212,1692245632468,1693217897043,534,256,278
1036,1693217897043,1692245632758,1692245633178,1693217897559,516,420,96
1037,1693217897559,1692245633280,1692245633549,1693217898108,549,269,280
1038,1693217898108,1692245633802,1692245634139,1693217898527,419,337,82
1039,1693217898527,1692245634227,1692245634662,1693217899052,525,435,90
1040,1693217899052,1692245634737,1692245634944,1693217899308,256,207,49
1041,1693217899309,1692245635017,1692245635478,1693217899903,594,461,133
1042,1693217899903,1692245635621,1692245635970,1693217900414,511,349,162
1043,1693217900414,1692245636127,1692245636361,1693217900777,363,234,129
1044,1693217900777,1692245636502,1692245636826,1693217901307,530,324,206
1045,1693217901307,1692245637052,1692245637267,1693217901730,423,215,208
1046,1693217901730,1692245637475,1692245637766,1693217902220,490,291,199
1047,1693217902221,1692245637974,1692245638309,1693217902707,486,335,151
1048,1693217902707,1692245638416,1692245638830,1693217903218,511,414,97
1049,1693217903218,1692245638936,1692245639270,1693217903669,451,334,117
1050,1693217903669,1692245639389,1692245639740,1693217904125,456,351,105
1051,1693217904125,1692245639841,1692245640096,1693217904521,396,255,141
1052,1693217904521,1692245640258,1692245640520,1693217904981,460,262,198
1053,1693217904981,1692245640719,1692245641075,1693217905469,488,356,132
1054,1693217905469,1692245641168,1692245641512,1693217905926,457,344,113
1055,1693217905926,1692245641637,1692245641950,1693217906342,416,313,103
1056,1693217906342,1692245642052,1692245642395,1693217906787,445,343,102
1057,1693217906787,1692245642529,1692245642719,1693217907144,357,190,167
1058,1693217907144,1692245642873,1692245643170,1693217907607,463,297,166
1059,1693217907608,1692245643307,1692245643604,1693217908005,397,297,100
1060,1693217908005,1692245643709,1692245644066,1693217908445,440,357,83
1061,1693217908445,1692245644168,1692245644376,1693217908822,377,208,169
1062,1693217908822,1692245644534,1692245644847,1693217909302,480,313,167
1063,1693217909302,1692245645018,1692245645396,1693217909872,570,378,192
1064,1693217909872,1692245645588,1692245645991,1693217910409,537,403,134
1065,1693217910409,1692245646116,1692245646521,1693217910910,501,405,96
1066,1693217910910,1692245646631,1692245646959,1693217911363,453,328,125
1067,1693217911363,1692245647063,1692245647452,1693217911862,499,389,110
1068,1693217911862,1692245647601,1692245647969,1693217912429,567,368,199
1069,1693217912429,1692245648200,1692245648454,1693217913008,579,254,325
1070,1693217913008,1692245648706,1692245648931,1693217913329,321,225,96
1071,1693217913329,1692245649045,1692245649363,1693217913767,438,318,120
1072,1693217913767,1692245649548,1692245649744,1693217914163,396,196,200
1073,1693217914163,1692245649904,1692245650166,1693217914585,422,262,160
1074,1693217914585,1692245650309,1692245650630,1693217915054,469,321,148
1075,1693217915054,1692245650767,1692245651110,1693217915545,491,343,148
1076,1693217915545,1692245651282,1692245651545,1693217915997,452,263,189
1077,1693217915997,1692245651697,1692245652019,1693217916408,411,322,89
1078,1693217916408,1692245652139,1692245652400,1693217916899,491,261,230
1079,1693217916899,1692245652638,1692245652919,1693217917306,407,281,126
1080,1693217917306,1692245653024,1692245653305,1693217917717,411,281,130
1081,1693217917717,1692245653429,1692245653842,1693217918305,588,413,175
1082,1693217918305,1692245654019,1692245654314,1693217918742,437,295,142
1083,1693217918742,1692245654460,1692245654785,1693217919177,435,325,110
1084,1693217919177,1692245654874,1692245655219,1693217919644,467,345,122
1085,1693217919644,1692245655356,1692245655759,1693217920151,507,403,104
1086,1693217920151,1692245655900,1692245656138,1693217920557,406,238,168
1087,1693217920557,1692245656267,1692245656561,1693217920957,400,294,106
1088,1693217920957,1692245656661,1692245656968,1693217921387,430,307,123
1089,1693217921387,1692245657113,1692245657329,1693217921732,345,216,129
1090,1693217921732,1692245657491,1692245657740,1693217922136,404,249,155
1091,1693217922136,1692245657854,1692245658225,1693217922619,483,371,112
1092,1693217922620,1692245658333,1692245658629,1693217923034,414,296,118
1093,1693217923211,1692245658945,1692245659544,1693217923941,730,599,131
1094,1693217923941,1692245659651,1692245660259,1693217924858,917,608,309
1095,1693217924858,1692245660598,1692245660944,1693217925380,522,346,176
1096,1693217925380,1692245661098,1692245661413,1693217925852,472,315,157
1097,1693217925852,1692245661619,1692245661825,1693217926366,514,206,308
1098,1693217926366,1692245662105,1692245662389,1693217926820,454,284,170
1099,1693217926820,1692245662525,1692245662802,1693217927182,362,277,85
1100,1693217927182,1692245662897,1692245663269,1693217927657,475,372,103
1101,1693217927657,1692245663362,1692245663701,1693217928143,486,339,147
1102,1693217928143,1692245663848,1692245664251,1693217928639,496,403,93
1103,1693217928639,1692245664369,1692245664590,1693217929009,370,221,149
1104,1693217929009,1692245664749,1692245664984,1693217929396,387,235,152
1105,1693217929396,1692245665111,1692245665445,1693217929874,478,334,144
1106,1693217929874,1692245665615,1692245665838,1693217930257,383,223,160
1107,1693217930258,1692245666006,1692245666216,1693217930634,376,210,166
1108,1693217930634,1692245666341,1692245666796,1693217931174,540,455,85
1109,1693217931174,1692245666891,1692245667250,1693217931687,513,359,154
1110,1693217931688,1692245667421,1692245667629,1693217932042,354,208,146
1111,1693217932042,1692245667770,1692245668127,1693217932551,509,357,152
1112,1693217932551,1692245668260,1692245668683,1693217933159,608,423,185
1113,1693217933159,1692245668897,1692245669304,1693217933696,537,407,130
1114,1693217933696,1692245669429,1692245669678,1693217934100,404,249,155
1115,1693217934100,1692245669800,1692245670144,1693217934572,472,344,128
1116,1693217934572,1692245670304,1692245670522,1693217934956,384,218,166
1117,1693217934956,1692245670713,1692245671130,1693217935548,592,417,175
1118,1693217935548,1692245671328,1692245671696,1693217936090,542,368,174
1119,1693217936090,1692245671799,1692245672157,1693217936560,470,358,112
1120,1693217936560,1692245672282,1692245672620,1693217937049,489,338,151
1121,1693217937049,1692245672752,1692245673140,1693217937554,505,388,117
1122,1693217937554,1692245673274,1692245673581,1693217937983,429,307,122
1123,1693217937983,1692245673687,1692245674055,1693217938447,464,368,96
1124,1693217938447,1692245674144,1692245674488,1693217938880,433,344,89
1125,1693217938880,1692245674608,1692245674839,1693217939323,443,231,212
1126,1693217939323,1692245675013,1692245675341,1693217939797,474,328,146
1127,1693217939797,1692245675522,1692245675789,1693217940237,440,267,173
1128,1693217940237,1692245675935,1692245676318,1693217940746,509,383,126
1129,1693217940746,1692245676442,1692245676788,1693217941333,587,346,241
1130,1693217941333,1692245677039,1692245677450,1693217941842,509,411,98
1131,1693217941842,1692245677551,1692245677792,1693217942199,357,241,116
1132,1693217942199,1692245677909,1692245678305,1693217942791,592,396,196
1133,1693217942791,1692245678501,1692245678842,1693217943303,512,341,171
1134,1693217943303,1692245679047,1692245679346,1693217943775,472,299,173
1135,1693217943775,1692245679518,1692245679850,1693217944242,467,332,135
1136,1693217944242,1692245679942,1692245680197,1693217944603,361,255,106
1137,1693217944604,1692245680307,1692245680637,1693217945067,463,330,133
1138,1693217945067,1692245680783,1692245681225,1693217945643,576,442,134
1139,1693217945643,1692245681378,1692245681651,1693217946086,443,273,170
1140,1693217946086,1692245681811,1692245682099,1693217946506,420,288,132
1141,1693217946506,1692245682233,1692245682524,1693217946929,423,291,132
1142,1693217946929,1692245682640,1692245682991,1693217947422,493,351,142
1143,1693217947422,1692245683136,1692245683443,1693217947843,421,307,114
1144,1693217947843,1692245683567,1692245683894,1693217948295,452,327,125
1145,1693217948295,1692245684007,1692245684304,1693217948699,404,297,107
1146,1693217948699,1692245684423,1692245684742,1693217949191,492,319,173
1147,1693217949191,1692245684947,1692245685240,1693217949649,458,293,165
1148,1693217949649,1692245685368,1692245685709,1693217950126,477,341,136
1149,1693217950126,1692245685831,1692245686085,1693217950484,358,254,104
1150,1693217950484,1692245686254,1692245686528,1693217950993,509,274,235
1151,1693217950993,1692245686785,1692245687059,1693217951466,473,274,199
1152,1693217951466,1692245687188,1692245687467,1693217951870,404,279,125
1153,1693217951870,1692245687581,1692245687920,1693217952364,494,339,155
1154,1693217952364,1692245688071,1692245688408,1693217952842,478,337,141
1155,1693217952842,1692245688586,1692245688925,1693217953372,530,339,191
1156,1693217956400,1692245692102,1692245692510,1693217956893,493,408,85
1157,1693217956893,1692245692591,1692245692998,1693217957432,539,407,132
1158,1693217957432,1692245693135,1692245693531,1693217957912,480,396,84
1159,1693217957912,1692245693621,1692245693996,1693217958451,539,375,164
1160,1693217958451,1692245694165,1692245694455,1693217958876,425,290,135
1161,1693217958876,1692245694589,1692245694980,1693217959374,498,391,107
1162,1693217959374,1692245695102,1692245695315,1693217959725,351,213,138
1163,1693217959725,1692245695435,1692245695839,1693217960302,577,404,173
1164,1693217960302,1692245696011,1692245696378,1693217960772,470,367,103
1165,1693217960772,1692245696486,1692245696790,1693217961209,437,304,133
1166,1693217961209,1692245696928,1692245697271,1693217961694,485,343,142
1167,1693217961694,1692245697417,1692245697746,1693217962140,446,329,117
1168,1693217962140,1692245697837,1692245698173,1693217962558,418,336,82
1169,1693217962558,1692245698317,1692245698539,1693217962980,422,222,200
1170,1693217962980,1692245698728,1692245699079,1693217963476,496,351,145
1171,1693217963476,1692245699187,1692245699633,1693217964049,573,446,127
1172,1693217964049,1692245699781,1692245700115,1693217964483,434,334,100
1173,1693217964483,1692245700214,1692245700611,1693217965061,578,397,181
1174,1693217965061,1692245700788,1692245700998,1693217965433,372,210,162
1175,1693217965433,1692245701166,1692245701458,1693217965935,502,292,210
1176,1693217965935,1692245701720,1692245701966,1693217966472,537,246,291
1177,1693217966472,1692245702222,1692245702528,1693217966920,448,306,142
1178,1693217966920,1692245702664,1692245703059,1693217967524,604,395,209
1179,1693217967524,1692245703245,1692245703614,1693217968090,566,369,197
1180,1693217968090,1692245703795,1692245704152,1693217968565,475,357,118
1181,1693217968565,1692245704263,1692245704591,1693217968963,398,328,70
1182,1693217968963,1692245704681,1692245705013,1693217969394,431,332,99
1183,1693217969394,1692245705114,1692245705358,1693217969825,431,244,187
1184,1693217969825,1692245705538,1692245705821,1693217970211,386,283,103
1185,1693217970211,1692245705910,1692245706335,1693217970737,526,425,101
1186,1693217970737,1692245706450,1692245706774,1693217971255,518,324,194
1187,1693217971255,1692245706953,1692245707350,1693217971857,602,397,205
1188,1693217971857,1692245707578,1692245707762,1693217972113,256,184,72
1189,1693217972113,1692245707823,1692245708096,1693217972501,388,273,115
1190,1693217972501,1692245708221,1692245708434,1693217972789,288,213,75
1191,1693217972789,1692245708497,1692245708882,1693217973298,509,385,124
1192,1693217973298,1692245709029,1692245709311,1693217973718,420,282,138
1193,1693217973718,1692245709418,1692245709700,1693217974101,383,282,101
1194,1693217974101,1692245709823,1692245710152,1693217974647,546,329,217
1195,1693217974647,1692245710365,1692245710682,1693217975152,505,317,188
1196,1693217975152,1692245710860,1692245711199,1693217975590,438,339,99
1197,1693217975590,1692245711312,1692245711598,1693217976021,431,286,145
1198,1693217976021,1692245711746,1692245712160,1693217976556,535,414,121
1199,1693217976556,1692245712261,1692245712681,1693217977085,529,420,109
1200,1693217977085,1692245712804,1692245713040,1693217977488,403,236,167
1201,1693217977488,1692245713195,1692245713557,1693217977931,443,362,81
1202,1693217977931,1692245713688,1692245713947,1693217978398,467,259,208
1203,1693217978398,1692245714102,1692245714496,1693217978861,463,394,69
1204,1693217978861,1692245714637,1692245714907,1693217979322,461,270,191
1205,1693217979322,1692245715033,1692245715402,1693217979791,469,369,100
1206,1693217979791,1692245715523,1692245715849,1693217980306,515,326,189
1207,1693217980306,1692245716026,1692245716356,1693217980755,449,330,119
1208,1693217980755,1692245716462,1692245716827,1693217981198,443,365,78
1209,1693217981198,1692245716911,1692245717297,1693217981692,494,386,108
1210,1693217981692,1692245717387,1692245717790,1693217982188,496,403,93
1211,1693217982188,1692245717910,1692245718218,1693217982628,440,308,132
1212,1693217982628,1692245718364,1692245718633,1693217983073,445,269,176
1213,1693217983073,1692245718784,1692245719151,1693217983801,728,367,361
1214,1693217983801,1692245719516,1692245719821,1693217984268,467,305,162
1215,1693217984268,1692245720000,1692245720233,1693217984866,598,233,365
1216,1693217984866,1692245720622,1692245720979,1693217985404,538,357,181
1217,1693217985404,1692245721116,1692245721380,1693217985858,454,264,190
1218,1693217985858,1692245721567,1692245721896,1693217986290,432,329,103
1219,1693217986290,1692245721997,1692245722324,1693217986699,409,327,82
1220,1693217986873,1692245722590,1692245723015,1693217987461,588,425,163
1221,1693217987461,1692245723218,1692245723831,1693217988215,754,613,141
1222,1693217988215,1692245723930,1692245724528,1693217988994,779,598,181
1223,1693217988994,1692245724713,1692245725047,1693217989476,482,334,148
1224,1693217989476,1692245725215,1692245725507,1693217990010,534,292,242
1225,1693217990010,1692245725773,1692245726034,1693217990436,426,261,165
1226,1693217990436,1692245726146,1692245726536,1693217991008,572,390,182
1227,1693217991008,1692245726701,1692245726975,1693217991333,325,274,51
1228,1693217991333,1692245727032,1692245727432,1693217991821,488,400,88
1229,1693217991821,1692245727532,1692245727816,1693217992214,393,284,109
1230,1693217992214,1692245727921,1692245728322,1693217992711,497,401,96
1231,1693217992711,1692245728413,1692245728820,1693217993204,493,407,86
1232,1693217993204,1692245728923,1692245729252,1693217993654,450,329,121
1233,1693217993654,1692245729357,1692245729761,1693217994193,539,404,135
1234,1693217994193,1692245729927,1692245730153,1693217994568,375,226,149
1235,1693217994568,1692245730286,1692245730627,1693217995115,547,341,206
1236,1693217995115,1692245730871,1692245731219,1693217995765,650,348,302
1237,1693217995765,1692245731516,1692245731794,1693217996198,433,278,155
1238,1693217996198,1692245731901,1692245732308,1693217996689,491,407,84
1239,1693217996689,1692245732397,1692245732725,1693217997124,435,328,107
1240,1693217997124,1692245732827,1692245733262,1693217997646,522,435,87
1241,1693217997646,1692245733328,1692245733656,1693217998048,402,328,74
1242,1693217998048,1692245733810,1692245734188,1693217998570,522,378,144
1243,1693217998570,1692245734330,1692245734533,1693217998998,428,203,225
1244,1693217998998,1692245734746,1692245735059,1693217999558,560,313,247
1245,1693217999558,1692245735262,1692245735703,1693218000110,552,441,111
1246,1693218000110,1692245735845,1692245736081,1693218000492,382,236,146
1247,1693218000492,1692245736192,1692245736586,1693218000956,464,394,70
1248,1693218000956,1692245736684,1692245737013,1693218001421,465,329,136
1249,1693218001421,1692245737127,1692245737457,1693218001854,433,330,103
1250,1693218001854,1692245737555,1692245737927,1693218002363,509,372,137
1251,1693218002363,1692245738097,1692245738419,1693218002940,577,322,255
1252,1693218002940,1692245738654,1692245739085,1693218003509,569,431,138
1253,1693218003510,1692245739252,1692245739650,1693218004140,630,398,232
1254,1693218004140,1692245739862,1692245740180,1693218004575,435,318,117
1255,1693218004575,1692245740281,1692245740646,1693218005029,454,365,89
1256,1693218005029,1692245740743,1692245740987,1693218005387,358,244,114
1257,1693218005387,1692245741101,1692245741444,1693218005881,494,343,151
1258,1693218005881,1692245741599,1692245741967,1693218006398,517,368,149
1259,1693218006398,1692245742120,1692245742516,1693218006930,532,396,136
1260,1693218006930,1692245742668,1692245743046,1693218007424,494,378,116
1261,1693218007424,1692245743147,1692245743397,1693218007797,373,250,123
1262,1693218007797,1692245743515,1692245743822,1693218008218,421,307,114
1263,1693218008218,1692245743930,1692245744192,1693218008599,381,262,119
1264,1693218008599,1692245744315,1692245744680,1693218009073,474,365,109
1265,1693218009073,1692245744797,1692245745124,1693218009521,448,327,121
1266,1693218009521,1692245745242,1692245745508,1693218009916,395,266,129
1267,1693218009916,1692245745619,1692245745966,1693218010417,501,347,154
1268,1693218010417,1692245746175,1692245746462,1693218010892,475,287,188
1269,1693218010892,1692245746610,1692245746925,1693218011317,425,315,110
1270,1693218011317,1692245747059,1692245747273,1693218011715,398,214,184
1271,1693218011715,1692245747433,1692245747795,1693218012194,479,362,117
1272,1693218012194,1692245747913,1692245748192,1693218012627,433,279,154
1273,1693218012627,1692245748342,1692245748625,1693218013026,399,283,116
1274,1693218013026,1692245748761,1692245749064,1693218013456,430,303,127
1275,1693218013456,1692245749172,1692245749547,1693218013951,495,375,120
1276,1693218013951,1692245749660,1692245749943,1693218014348,397,283,114
1277,1693218014348,1692245750083,1692245750368,1693218014898,550,285,265
1278,1693218014898,1692245750645,1692245751002,1693218015381,483,357,126
1279,1693218015381,1692245751103,1692245751408,1693218015810,429,305,124
1280,1693218015810,1692245751534,1692245751810,1693218016271,461,276,185
1281,1693218016271,1692245751993,1692245752369,1693218016869,598,376,222
1282,1693218016869,1692245752580,1692245752906,1693218017322,453,326,127
1283,1693218023363,1692245759091,1692245759332,1693218023759,396,241,155
1284,1693218023760,1692245759461,1692245759916,1693218024292,532,455,77
1285,1693218024292,1692245760024,1692245760298,1693218024747,455,274,181
1286,1693218024747,1692245760479,1692245760673,1693218025172,425,194,231
1287,1693218025172,1692245760882,1692245761266,1693218025708,536,384,152
1288,1693218025708,1692245761431,1692245761716,1693218026120,412,285,127
1289,1693218026120,1692245761830,1692245762041,1693218026440,320,211,109
1290,1693218026440,1692245762163,1692245762438,1693218026836,396,275,121
1291,1693218026836,1692245762550,1692245762948,1693218027347,511,398,113
1292,1693218027347,1692245763088,1692245763339,1693218027751,404,251,153
1293,1693218027751,1692245763469,1692245763731,1693218028112,361,262,99
1294,1693218028112,1692245763854,1692245764055,1693218028515,403,201,202
1295,1693218028515,1692245764256,1692245764492,1693218028917,402,236,166
1296,1693218028917,1692245764668,1692245764963,1693218029428,511,295,216
1297,1693218029428,1692245765169,1692245765457,1693218029834,406,288,118
1298,1693218029834,1692245765542,1692245765917,1693218030336,502,375,127
1299,1693218030336,1692245766068,1692245766308,1693218030714,378,240,138
1300,1693218030714,1692245766435,1692245766684,1693218031131,417,249,168
1301,1693218031131,1692245766825,1692245767192,1693218031572,441,367,74
1302,1693218031572,1692245767316,1692245767735,1693218032116,544,419,125
1303,1693218032116,1692245767834,1692245768051,1693218032481,365,217,148
1304,1693218032481,1692245768218,1692245768513,1693218032943,462,295,167
1305,1693218032943,1692245768656,1692245768934,1693218033329,386,278,108
1306,1693218033329,1692245769043,1692245769362,1693218033744,415,319,96
1307,1693218033744,1692245769498,1692245769739,1693218034148,404,241,163
1308,1693218034148,1692245769856,1692245770144,1693218034534,386,288,98
1309,1693218034534,1692245770254,1692245770521,1693218034974,440,267,173
1310,1693218034974,1692245770689,1692245771061,1693218035486,512,372,140
1311,1693218035486,1692245771204,1692245771482,1693218035965,479,278,201
1312,1693218035965,1692245771663,1692245771965,1693218036406,441,302,139
1313,1693218036406,1692245772133,1692245772484,1693218036884,478,351,127
1314,1693218036884,1692245772578,1692245772954,1693218037366,482,376,106
1315,1693218037366,1692245773130,1692245773413,1693218037821,455,283,172
1316,1693218037821,1692245773564,1692245773820,1693218038259,438,256,182
1317,1693218038259,1692245773948,1692245774287,1693218038728,469,339,130
1318,1693218038728,1692245774448,1692245774808,1693218039269,541,360,181
1319,1693218039269,1692245774994,1692245775329,1693218039723,454,335,119
1320,1693218039723,1692245775447,1692245775721,1693218040176,453,274,179
1321,1693218040177,1692245775911,1692245776331,1693218040713,536,420,116
1322,1693218040713,1692245776450,1692245776763,1693218041177,464,313,151
1323,1693218041177,1692245776906,1692245777211,1693218041644,467,305,162
1324,1693218041644,1692245777345,1692245777748,1693218042128,484,403,81
1325,1693218042128,1692245777828,1692245778143,1693218042526,398,315,83
1326,1693218042526,1692245778261,1692245778541,1693218043027,501,280,221
1327,1693218043027,1692245778726,1692245779128,1693218043548,521,402,119
1328,1693218043548,1692245779262,1692245779621,1693218044048,500,359,141
1329,1693218044048,1692245779748,1692245780072,1693218044454,406,324,82
1330,1693218044455,1692245780168,1692245780489,1693218044997,542,321,221
1331,1693218044997,1692245780721,1692245781054,1693218045452,455,333,122
1332,1693218045452,1692245781170,1692245781414,1693218045909,457,244,213
1333,1693218045909,1692245781617,1692245781902,1693218046290,381,285,96
1334,1693218046290,1692245782010,1692245782301,1693218046737,447,291,156
1335,1693218046737,1692245782448,1692245782836,1693218047249,512,388,124
1336,1693218047249,1692245782968,1692245783327,1693218047747,498,359,139
1337,1693218047747,1692245783458,1692245783818,1693218048231,484,360,124
1338,1693218048231,1692245783948,1692245784239,1693218048624,393,291,102
1339,1693218048624,1692245784366,1692245784588,1693218049090,466,222,244
1340,1693218049090,1692245784818,1692245785132,1693218049516,426,314,112
1341,1693218049517,1692245785261,1692245785488,1693218049896,379,227,152
1342,1693218049896,1692245785626,1692245785846,1693218050260,364,220,144
1343,1693218050260,1692245785965,1692245786331,1693218050705,445,366,79
1344,1693218050705,1692245786443,1692245786670,1693218051077,372,227,145
1345,1693218051077,1692245786790,1692245787080,1693218051461,384,290,94
1346,1693218051461,1692245787164,1692245787574,1693218051956,495,410,85
1347,1693218051956,1692245787676,1692245787981,1693218052379,423,305,118
1348,1693218052379,1692245788088,1692245788476,1693218052852,473,388,85
1349,1693218052852,1692245788565,1692245788893,1693218053278,426,328,98
1350,1693218053278,1692245788992,1692245789291,1693218053686,408,299,109
