request_number,request_time_ms,request_received_time_ms,response_time_ms,response_received_time_ms,end_to_end_latency,compute_time,transmission_time
1,1693233692278,1692261428290,1692261428494,1693233692667,389,204,185
2,1693233692667,1692261428534,1692261428722,1693233692895,228,188,40
3,1693233692895,1692261428779,1692261428961,1693233693135,240,182,58
4,1693233693135,1692261429004,1692261429192,1693233693366,231,188,43
5,1693233693366,1692261429346,1692261429531,1693233693704,338,185,153
6,1693233693705,1692261429580,1692261429752,1693233693928,223,172,51
7,1693233693928,1692261429821,1692261429993,1693233694165,237,172,65
8,1693233694166,1692261430065,1692261430237,1693233694409,243,172,71
9,1693233694409,1692261430287,1692261430460,1693233694632,223,173,50
10,1693233694632,1692261430509,1692261430680,1693233694851,219,171,48
11,1693233694852,1692261430723,1692261430895,1693233695066,214,172,42
12,1693233695066,1692261430927,1692261431097,1693233695269,203,170,33
13,1693233695269,1692261431134,1692261431304,1693233695476,207,170,37
14,1693233695476,1692261431396,1692261431569,1693233695743,267,173,94
15,1693233695743,1692261431599,1692261431769,1693233695941,198,170,28
16,1693233695941,1692261431815,1692261431985,1693233696157,216,170,46
17,1693233696157,1692261432013,1692261432183,1693233696355,198,170,28
18,1693233696355,1692261432215,1692261432385,1693233696556,201,170,31
19,1693233696556,1692261432423,1692261432594,1693233696766,210,171,39
20,1693233696766,1692261432647,1692261432819,1693233696991,225,172,53
21,1693233696991,1692261432875,1692261433051,1693233697223,232,176,56
22,1693233697223,1692261433132,1692261433304,1693233697476,253,172,81
23,1693233697476,1692261433340,1692261433510,1693233697682,206,170,36
24,1693233697682,1692261433546,1692261433718,1693233697890,208,172,36
25,1693233697890,1692261433783,1692261433958,1693233698130,240,175,65
26,1693233698130,1692261434030,1692261434203,1693233698375,245,173,72
27,1693233698375,1692261434243,1692261434413,1693233698586,211,170,41
28,1693233698586,1692261434445,1692261434614,1693233698790,204,169,35
29,1693233698791,1692261434654,1692261434825,1693233698998,207,171,36
30,1693233698998,1692261434877,1692261435050,1693233699221,223,173,50
31,1693233699222,1692261435111,1692261435285,1693233699457,235,174,61
32,1693233699457,1692261435342,1692261435515,1693233699687,230,173,57
33,1693233699687,1692261435563,1692261435733,1693233699905,218,170,48
34,1693233699905,1692261435780,1692261435953,1693233700125,220,173,47
35,1693233700125,1692261436020,1692261436194,1693233700366,241,174,67
36,1693233700366,1692261436229,1692261436398,1693233700570,204,169,35
37,1693233700570,1692261436468,1692261436642,1693233700813,243,174,69
38,1693233700813,1692261436698,1692261436868,1693233701041,228,170,58
39,1693233701041,1692261436910,1692261437082,1693233701253,212,172,40
40,1693233701253,1692261437129,1692261437300,1693233701472,219,171,48
41,1693233701472,1692261437357,1692261437531,1693233701703,231,174,57
42,1693233701703,1692261437599,1692261437775,1693233701947,244,176,68
43,1693233701947,1692261437830,1692261438001,1693233702174,227,171,56
44,1693233702174,1692261438039,1692261438215,1693233702387,213,176,37
45,1693233702387,1692261438281,1692261438455,1693233702626,239,174,65
46,1693233702626,1692261438514,1692261438684,1693233702856,230,170,60
47,1693233702856,1692261438723,1692261438893,1693233703065,209,170,39
48,1693233703065,1692261438936,1692261439106,1693233703277,212,170,42
49,1693233703278,1692261439167,1692261439339,1693233703510,232,172,60
50,1693233703510,1692261439393,1692261439564,1693233703736,226,171,55
51,1693233703736,1692261439614,1692261439788,1693233703960,224,174,50
52,1693233703960,1692261439823,1692261439993,1693233704165,205,170,35
53,1693233704165,1692261440020,1692261440190,1693233704362,197,170,27
54,1693233704362,1692261440234,1692261440405,1693233704577,215,171,44
55,1693233704577,1692261440451,1692261440624,1693233704795,218,173,45
56,1693233704795,1692261440668,1692261440838,1693233705010,215,170,45
57,1693233705010,1692261440909,1692261441081,1693233705254,244,172,72
58,1693233705254,1692261441119,1692261441290,1693233705462,208,171,37
59,1693233705462,1692261441326,1692261441497,1693233705669,207,171,36
60,1693233705669,1692261441535,1692261441706,1693233705879,210,171,39
61,1693233705879,1692261441755,1692261441928,1693233706100,221,173,48
62,1693233706100,1692261441968,1692261442141,1693233706312,212,173,39
63,1693233706313,1692261442184,1692261442356,1693233706571,258,172,86
64,1693233706571,1692261442457,1692261442629,1693233706878,307,172,135
65,1693233706878,1692261442768,1692261442943,1693233707114,236,175,61
66,1693233707114,1692261442988,1692261443161,1693233707392,278,173,105
67,1693233707392,1692261443272,1692261443443,1693233707675,283,171,112
68,1693233707675,1692261443547,1692261443718,1693233707890,215,171,44
69,1693233707890,1692261443781,1692261443956,1693233708128,238,175,63
70,1693233708128,1692261443987,1692261444156,1693233708330,202,169,33
71,1693233708330,1692261444196,1692261444367,1693233708539,209,171,38
72,1693233708539,1692261444412,1692261444586,1693233708758,219,174,45
73,1693233708758,1692261444639,1692261444811,1693233708983,225,172,53
74,1693233708983,1692261444849,1692261445020,1693233709192,209,171,38
75,1693233709192,1692261445072,1692261445246,1693233709417,225,174,51
76,1693233709417,1692261445283,1692261445453,1693233709625,208,170,38
77,1693233709625,1692261445497,1692261445670,1693233709906,281,173,108
78,1693233709906,1692261445816,1692261445988,1693233710161,255,172,83
79,1693233710161,1692261446043,1692261446216,1693233710388,227,173,54
80,1693233710388,1692261446275,1692261446447,1693233710619,231,172,59
81,1693233710619,1692261446489,1692261446661,1693233710832,213,172,41
82,1693233710832,1692261446724,1692261446898,1693233711070,238,174,64
83,1693233711070,1692261446948,1692261447118,1693233711290,220,170,50
84,1693233711290,1692261447168,1692261447341,1693233711513,223,173,50
85,1693233711513,1692261447413,1692261447588,1693233711761,248,175,73
86,1693233711761,1692261447634,1692261447804,1693233711975,214,170,44
87,1693233711975,1692261447852,1692261448022,1693233712194,219,170,49
88,1693233712194,1692261448065,1692261448234,1693233712411,217,169,48
89,1693233712411,1692261448272,1692261448443,1693233712616,205,171,34
90,1693233712616,1692261448486,1692261448657,1693233712829,213,171,42
91,1693233712829,1692261448700,1692261448871,1693233713042,213,171,42
92,1693233713042,1692261448924,1692261449099,1693233713271,229,175,54
93,1693233713271,1692261449147,1692261449320,1693233713492,221,173,48
94,1693233713493,1692261449377,1692261449550,1693233713722,229,173,56
95,1693233713722,1692261449604,1692261449778,1693233713950,228,174,54
96,1693233713950,1692261449837,1692261450008,1693233714180,230,171,59
97,1693233714180,1692261450047,1692261450218,1693233714389,209,171,38
98,1693233714389,1692261450253,1692261450421,1693233714593,204,168,36
99,1693233714593,1692261450456,1692261450627,1693233714799,206,171,35
100,1693233714799,1692261450666,1692261450836,1693233715008,209,170,39
101,1693233715008,1692261450860,1692261451031,1693233715203,195,171,24
102,1693233715203,1692261451078,1692261451249,1693233715420,217,171,46
103,1693233715420,1692261451289,1692261451458,1693233715630,210,169,41
104,1693233715630,1692261451496,1692261451666,1693233715838,208,170,38
105,1693233715838,1692261451707,1692261451878,1693233716051,213,171,42
106,1693233716051,1692261451929,1692261452102,1693233716273,222,173,49
107,1693233716273,1692261452142,1692261452312,1693233716483,210,170,40
108,1693233716484,1692261452376,1692261452547,1693233716718,234,171,63
109,1693233716718,1692261452564,1692261452736,1693233716907,189,172,17
110,1693233716907,1692261452770,1692261452939,1693233717111,204,169,35
111,1693233717111,1692261452969,1692261453139,1693233717311,200,170,30
112,1693233717312,1692261453192,1692261453369,1693233717540,228,177,51
113,1693233717540,1692261453426,1692261453597,1693233717769,229,171,58
114,1693233717769,1692261453627,1692261453796,1693233717968,199,169,30
115,1693233717968,1692261453851,1692261454027,1693233718198,230,176,54
116,1693233718198,1692261454100,1692261454272,1693233718444,246,172,74
117,1693233718444,1692261454317,1692261454490,1693233718661,217,173,44
118,1693233718661,1692261454518,1692261454687,1693233718861,200,169,31
119,1693233718861,1692261454731,1692261454902,1693233719074,213,171,42
120,1693233719074,1692261454954,1692261455125,1693233719297,223,171,52
121,1693233719297,1692261455194,1692261455367,1693233719538,241,173,68
122,1693233719538,1692261455412,1692261455585,1693233719757,219,173,46
123,1693233719757,1692261455638,1692261455808,1693233719979,222,170,52
124,1693233719979,1692261455858,1692261456029,1693233720200,221,171,50
125,1693233720201,1692261456107,1692261456280,1693233720452,251,173,78
126,1693233720452,1692261456312,1692261456481,1693233720652,200,169,31
127,1693233720652,1692261456501,1692261456670,1693233720841,189,169,20
128,1693233720841,1692261456725,1692261456897,1693233721068,227,172,55
129,1693233721068,1692261456932,1692261457103,1693233721275,207,171,36
130,1693233721275,1692261457155,1692261457327,1693233721498,223,172,51
131,1693233721498,1692261457377,1692261457549,1693233721734,236,172,64
132,1693233721734,1692261457617,1692261457792,1693233721963,229,175,54
133,1693233721963,1692261457834,1692261458004,1693233722176,213,170,43
134,1693233722176,1692261458056,1692261458226,1693233722397,221,170,51
135,1693233722568,1692261458432,1692261458788,1693233723062,494,356,138
136,1693233723062,1692261458950,1692261459284,1693233723470,408,334,74
137,1693233723470,1692261459365,1692261459707,1693233723961,491,342,149
138,1693233723961,1692261459840,1692261460093,1693233724281,320,253,67
139,1693233724281,1692261460175,1692261460358,1693233724541,260,183,77
140,1693233724541,1692261460434,1692261460607,1693233724778,237,173,64
141,1693233724778,1692261460646,1692261460817,1693233724988,210,171,39
142,1693233724988,1692261460852,1692261461020,1693233725192,204,168,36
143,1693233725192,1692261461100,1692261461274,1693233725446,254,174,80
144,1693233725446,1692261461316,1692261461487,1693233725659,213,171,42
145,1693233725659,1692261461534,1692261461704,1693233725876,217,170,47
146,1693233725876,1692261461765,1692261461936,1693233726107,231,171,60
147,1693233726107,1692261461981,1692261462152,1693233726324,217,171,46
148,1693233726324,1692261462237,1692261462410,1693233726582,258,173,85
149,1693233726582,1692261462451,1692261462622,1693233726794,212,171,41
150,1693233726794,1692261462682,1692261462854,1693233727026,232,172,60
151,1693233727026,1692261462896,1692261463068,1693233727239,213,172,41
152,1693233727239,1692261463119,1692261463290,1693233727462,223,171,52
153,1693233727462,1692261463349,1692261463521,1693233727693,231,172,59
154,1693233727693,1692261463563,1692261463735,1693233727907,214,172,42
155,1693233727907,1692261463780,1692261463953,1693233728124,217,173,44
156,1693233728124,1692261464005,1692261464177,1693233728349,225,172,53
157,1693233728349,1692261464222,1692261464394,1693233728565,216,172,44
158,1693233728565,1692261464428,1692261464599,1693233728772,207,171,36
159,1693233728773,1692261464650,1692261464822,1693233728996,223,172,51
160,1693233728996,1692261464856,1692261465031,1693233729206,210,175,35
161,1693233729206,1692261465059,1692261465229,1693233729401,195,170,25
162,1693233729401,1692261465277,1692261465448,1693233729619,218,171,47
163,1693233729619,1692261465498,1692261465670,1693233729841,222,172,50
164,1693233729841,1692261465729,1692261465902,1693233730073,232,173,59
165,1693233730073,1692261465937,1692261466106,1693233730278,205,169,36
166,1693233730278,1692261466145,1692261466316,1693233730488,210,171,39
167,1693233730488,1692261466359,1692261466532,1693233730703,215,173,42
168,1693233730703,1692261466600,1692261466772,1693233730945,242,172,70
169,1693233730945,1692261466825,1692261467002,1693233731173,228,177,51
170,1693233731173,1692261467042,1692261467217,1693233731389,216,175,41
171,1693233731389,1692261467271,1692261467452,1693233731623,234,181,53
172,1693233731624,1692261467495,1692261467671,1693233731843,219,176,43
173,1693233731843,1692261467720,1692261467902,1693233732074,231,182,49
174,1693233732074,1692261467968,1692261468159,1693233732330,256,191,65
175,1693233732330,1692261468244,1692261468423,1693233732594,264,179,85
176,1693233732595,1692261468465,1692261468639,1693233732811,216,174,42
177,1693233732811,1692261468701,1692261468872,1693233733044,233,171,62
178,1693233733044,1692261468920,1692261469092,1693233733263,219,172,47
179,1693233733263,1692261469139,1692261469310,1693233733481,218,171,47
180,1693233733481,1692261469367,1692261469545,1693233733716,235,178,57
181,1693233733716,1692261469582,1692261469752,1693233733924,208,170,38
182,1693233733924,1692261469798,1692261469970,1693233734142,218,172,46
183,1693233734142,1692261470002,1692261470172,1693233734343,201,170,31
184,1693233734343,1692261470201,1692261470372,1693233734544,201,171,30
185,1693233734544,1692261470422,1692261470593,1693233734764,220,171,49
186,1693233734764,1692261470640,1692261470811,1693233734983,219,171,48
187,1693233734983,1692261470849,1692261471017,1693233735193,210,168,42
188,1693233735193,1692261471056,1692261471227,1693233735398,205,171,34
189,1693233735398,1692261471272,1692261471442,1693233735613,215,170,45
190,1693233735613,1692261471523,1692261471696,1693233735867,254,173,81
191,1693233735867,1692261471764,1692261471940,1693233736111,244,176,68
192,1693233736111,1692261471991,1692261472162,1693233736334,223,171,52
193,1693233736334,1692261472215,1692261472386,1693233736557,223,171,52
194,1693233736557,1692261472442,1692261472615,1693233736787,230,173,57
195,1693233736787,1692261472667,1692261472837,1693233737009,222,170,52
196,1693233737009,1692261472886,1692261473059,1693233737231,222,173,49
197,1693233737231,1692261473114,1692261473286,1693233737457,226,172,54
198,1693233737457,1692261473325,1692261473497,1693233737669,212,172,40
199,1693233737669,1692261473550,1692261473722,1693233737893,224,172,52
200,1693233737893,1692261473781,1692261473953,1693233738124,231,172,59
201,1693233738124,1692261473992,1692261474169,1693233738340,216,177,39
202,1693233738340,1692261474186,1692261474355,1693233738527,187,169,18
203,1693233738527,1692261474419,1692261474595,1693233738767,240,176,64
204,1693233738767,1692261474655,1692261474830,1693233739002,235,175,60
205,1693233739002,1692261474907,1692261475088,1693233739259,257,181,76
206,1693233739259,1692261475131,1692261475306,1693233739478,219,175,44
207,1693233739478,1692261475343,1692261475514,1693233739687,209,171,38
208,1693233739687,1692261475574,1692261475752,1693233740080,393,178,215
209,1693233740080,1692261475939,1692261476110,1693233740282,202,171,31
210,1693233740282,1692261476146,1692261476320,1693233740491,209,174,35
211,1693233740491,1692261476370,1692261476542,1693233740714,223,172,51
212,1693233740714,1692261476597,1692261476769,1693233740940,226,172,54
213,1693233740940,1692261476796,1692261476964,1693233741136,196,168,28
214,1693233741136,1692261476997,1692261477167,1693233741338,202,170,32
215,1693233741338,1692261477235,1692261477406,1693233741577,239,171,68
216,1693233741577,1692261477457,1692261477628,1693233741799,222,171,51
217,1693233741799,1692261477677,1692261477848,1693233742019,220,171,49
218,1693233742019,1692261477888,1692261478061,1693233742232,213,173,40
219,1693233742232,1692261478123,1692261478296,1693233742468,236,173,63
220,1693233742468,1692261478361,1692261478533,1693233742705,237,172,65
221,1693233742705,1692261478573,1692261478744,1693233742916,211,171,40
222,1693233742916,1692261478805,1692261478976,1693233743147,231,171,60
223,1693233743147,1692261479007,1692261479176,1693233743349,202,169,33
224,1693233743349,1692261479227,1692261479399,1693233743570,221,172,49
225,1693233743570,1692261479455,1692261479626,1693233743797,227,171,56
226,1693233743797,1692261479667,1692261479838,1693233744009,212,171,41
227,1693233744009,1692261479891,1692261480061,1693233744232,223,170,53
228,1693233744232,1692261480115,1692261480288,1693233744462,230,173,57
229,1693233744462,1692261480322,1692261480493,1693233744666,204,171,33
230,1693233744666,1692261480542,1692261480714,1693233744885,219,172,47
231,1693233744885,1692261480752,1692261480925,1693233745096,211,173,38
232,1693233745096,1692261480969,1692261481144,1693233745315,219,175,44
233,1693233745315,1692261481216,1692261481392,1693233745564,249,176,73
234,1693233745564,1692261481427,1692261481605,1693233745777,213,178,35
235,1693233745777,1692261481666,1692261481853,1693233746025,248,187,61
236,1693233746025,1692261481885,1692261482065,1693233746237,212,180,32
237,1693233746237,1692261482096,1692261482270,1693233746442,205,174,31
238,1693233746442,1692261482320,1692261482496,1693233746668,226,176,50
239,1693233746668,1692261482528,1692261482730,1693233746902,234,202,32
240,1693233746902,1692261482777,1692261482954,1693233747126,224,177,47
241,1693233747126,1692261483049,1692261483221,1693233747392,266,172,94
242,1693233747392,1692261483340,1692261483512,1693233747683,291,172,119
243,1693233747683,1692261483578,1692261483749,1693233747920,237,171,66
244,1693233747921,1692261483797,1692261483969,1693233748141,220,172,48
245,1693233748141,1692261483999,1692261484166,1693233748338,197,167,30
246,1693233748338,1692261484208,1692261484379,1693233748550,212,171,41
247,1693233748550,1692261484440,1692261484614,1693233748785,235,174,61
248,1693233748785,1692261484645,1692261484815,1693233748986,201,170,31
249,1693233748986,1692261484882,1692261485055,1693233749226,240,173,67
250,1693233749226,1692261485111,1692261485284,1693233749455,229,173,56
251,1693233749455,1692261485331,1692261485505,1693233749676,221,174,47
252,1693233749676,1692261485533,1692261485703,1693233749874,198,170,28
253,1693233749874,1692261485755,1692261485927,1693233750098,224,172,52
254,1693233750098,1692261485958,1692261486130,1693233750301,203,172,31
255,1693233750301,1692261486159,1692261486331,1693233750503,202,172,30
256,1693233750503,1692261486375,1692261486548,1693233750719,216,173,43
257,1693233750719,1692261486606,1692261486780,1693233750953,234,174,60
258,1693233750953,1692261486850,1692261487022,1693233751194,241,172,69
259,1693233751195,1692261487105,1692261487280,1693233751451,256,175,81
260,1693233751452,1692261487317,1692261487488,1693233751659,207,171,36
261,1693233751659,1692261487522,1692261487693,1693233751865,206,171,35
262,1693233751865,1692261487735,1692261487906,1693233752079,214,171,43
263,1693233752079,1692261487941,1692261488111,1693233752282,203,170,33
264,1693233752282,1692261488150,1692261488323,1693233752494,212,173,39
265,1693233752495,1692261488376,1692261488547,1693233752719,224,171,53
266,1693233752727,1692261488608,1692261488779,1693233752950,223,171,52
267,1693233752950,1692261488819,1692261488990,1693233753162,212,171,41
268,1693233753162,1692261489039,1692261489211,1693233753382,220,172,48
269,1693233753382,1692261489252,1692261489424,1693233753595,213,172,41
270,1693233753595,1692261489478,1692261489650,1693233753822,227,172,55
271,1693233753822,1692261489672,1692261489841,1693233754012,190,169,21
272,1693233754012,1692261489869,1692261490038,1693233754209,197,169,28
273,1693233754209,1692261490087,1692261490258,1693233754429,220,171,49
274,1693233754429,1692261490302,1692261490471,1693233754643,214,169,45
275,1693233754643,1692261490535,1692261490707,1693233754879,236,172,64
276,1693233754879,1692261490761,1692261490933,1693233755112,233,172,61
277,1693233755112,1692261490989,1692261491163,1693233755334,222,174,48
278,1693233755334,1692261491199,1692261491370,1693233755541,207,171,36
279,1693233755541,1692261491440,1692261491612,1693233755784,243,172,71
280,1693233755784,1692261491648,1692261491821,1693233755992,208,173,35
281,1693233755992,1692261491912,1692261492083,1693233756254,262,171,91
282,1693233756254,1692261492136,1692261492308,1693233756479,225,172,53
283,1693233756479,1692261492340,1692261492511,1693233756682,203,171,32
284,1693233756682,1692261492540,1692261492709,1693233756880,198,169,29
285,1693233756880,1692261492734,1692261492903,1693233757074,194,169,25
286,1693233757074,1692261492976,1692261493148,1693233757320,246,172,74
287,1693233757320,1692261493201,1692261493373,1693233757544,224,172,52
288,1693233757544,1692261493459,1692261493632,1693233757803,259,173,86
289,1693233757803,1692261493685,1692261493857,1693233758028,225,172,53
290,1693233758028,1692261493882,1692261494053,1693233758224,196,171,25
291,1693233758224,1692261494108,1692261494281,1693233758452,228,173,55
292,1693233758452,1692261494352,1692261494524,1693233758696,244,172,72
293,1693233758696,1692261494569,1692261494742,1693233758913,217,173,44
294,1693233758913,1692261494779,1692261494949,1693233759120,207,170,37
295,1693233759120,1692261494982,1692261495152,1693233759323,203,170,33
296,1693233759323,1692261495222,1692261495392,1693233759563,240,170,70
297,1693233759563,1692261495421,1692261495592,1693233759763,200,171,29
298,1693233759763,1692261495638,1692261495809,1693233759980,217,171,46
299,1693233759980,1692261495836,1692261496007,1693233760178,198,171,27
300,1693233760178,1692261496046,1692261496217,1693233760388,210,171,39
301,1693233760388,1692261496260,1692261496432,1693233760603,215,172,43
302,1693233760603,1692261496491,1692261496663,1693233760834,231,172,59
303,1693233760834,1692261496708,1692261496880,1693233761051,217,172,45
304,1693233761051,1692261496919,1692261497089,1693233761260,209,170,39
305,1693233761260,1692261497126,1692261497295,1693233761466,206,169,37
306,1693233761466,1692261497330,1692261497498,1693233761669,203,168,35
307,1693233761669,1692261497540,1692261497711,1693233761882,213,171,42
308,1693233761882,1692261497776,1692261497947,1693233762121,239,171,68
309,1693233762121,1692261498023,1692261498196,1693233762367,246,173,73
310,1693233762367,1692261498239,1692261498411,1693233762585,218,172,46
311,1693233762585,1692261498471,1692261498642,1693233762813,228,171,57
312,1693233762814,1692261498676,1692261498847,1693233763018,204,171,33
313,1693233763018,1692261498884,1692261499054,1693233763226,208,170,38
314,1693233763226,1692261499094,1692261499265,1693233763436,210,171,39
315,1693233763436,1692261499309,1692261499480,1693233763651,215,171,44
316,1693233763651,1692261499525,1692261499695,1693233763866,215,170,45
317,1693233763866,1692261499729,1692261499901,1693233764071,205,172,33
318,1693233764072,1692261499927,1692261500096,1693233764268,196,169,27
319,1693233764268,1692261500135,1692261500305,1693233764477,209,170,39
320,1693233764477,1692261500353,1692261500528,1693233764699,222,175,47
321,1693233764699,1692261500575,1692261500745,1693233764916,217,170,47
322,1693233764916,1692261500807,1692261500979,1693233765150,234,172,62
323,1693233765150,1692261501027,1692261501200,1693233765372,222,173,49
324,1693233765372,1692261501240,1692261501410,1693233765581,209,170,39
325,1693233765581,1692261501441,1692261501611,1693233765782,201,170,31
326,1693233765782,1692261501659,1692261501830,1693233766001,219,171,48
327,1693233766001,1692261501887,1692261502058,1693233766229,228,171,57
328,1693233766230,1692261502133,1692261502305,1693233766476,246,172,74
329,1693233766476,1692261502346,1692261502519,1693233766690,214,173,41
330,1693233766690,1692261502567,1692261502740,1693233766912,222,173,49
331,1693233766912,1692261502768,1692261502937,1693233767108,196,169,27
332,1693233767108,1692261502980,1692261503152,1693233767322,214,172,42
333,1693233767322,1692261503173,1692261503343,1693233767515,193,170,23
334,1693233767515,1692261503397,1692261503568,1693233767739,224,171,53
335,1693233767739,1692261503604,1692261503774,1693233767945,206,170,36
336,1693233767945,1692261503826,1692261503997,1693233768168,223,171,52
337,1693233768168,1692261504039,1692261504213,1693233768384,216,174,42
338,1693233768384,1692261504270,1692261504443,1693233768634,250,173,77
339,1693233768634,1692261504502,1692261504673,1693233768849,215,171,44
340,1693233768849,1692261504740,1692261504913,1693233769084,235,173,62
341,1693233769084,1692261504948,1692261505119,1693233769290,206,171,35
342,1693233769290,1692261505165,1692261505338,1693233769509,219,173,46
343,1693233769509,1692261505374,1692261505546,1693233769717,208,172,36
344,1693233769717,1692261505588,1692261505757,1693233770083,366,169,197
345,1693233770083,1692261505949,1692261506121,1693233770293,210,172,38
346,1693233770293,1692261506162,1692261506332,1693233770503,210,170,40
347,1693233770503,1692261506376,1692261506550,1693233770722,219,174,45
348,1693233770722,1692261506610,1692261506782,1693233770953,231,172,59
349,1693233770953,1692261506817,1692261506989,1693233771160,207,172,35
350,1693233771161,1692261507045,1692261507217,1693233771388,227,172,55
351,1693233771388,1692261507276,1692261507448,1693233771620,232,172,60
352,1693233771620,1692261507494,1692261507665,1693233771836,216,171,45
353,1693233771836,1692261507686,1692261507856,1693233772027,191,170,21
354,1693233772027,1692261507909,1692261508080,1693233772251,224,171,53
355,1693233772251,1692261508141,1692261508315,1693233772486,235,174,61
356,1693233772486,1692261508372,1692261508544,1693233772715,229,172,57
357,1693233772715,1692261508602,1692261508775,1693233772947,232,173,59
358,1693233772947,1692261508836,1692261509010,1693233773181,234,174,60
359,1693233773181,1692261509048,1692261509219,1693233773390,209,171,38
360,1693233773390,1692261509253,1692261509424,1693233773595,205,171,34
361,1693233773595,1692261509485,1692261509656,1693233773827,232,171,61
362,1693233773827,1692261509710,1692261509881,1693233774052,225,171,54
363,1693233774052,1692261509913,1692261510085,1693233774256,204,172,32
364,1693233774256,1692261510125,1692261510296,1693233774473,217,171,46
365,1693233774473,1692261510358,1692261510533,1693233774704,231,175,56
366,1693233774704,1692261510583,1692261510755,1693233774926,222,172,50
367,1693233774926,1692261510818,1692261510990,1693233775161,235,172,63
368,1693233775161,1692261511069,1692261511243,1693233775415,254,174,80
369,1693233775415,1692261511278,1692261511448,1693233775619,204,170,34
370,1693233775619,1692261511537,1692261511710,1693233775881,262,173,89
371,1693233775881,1692261511779,1692261511952,1693233776123,242,173,69
372,1693233776123,1692261512021,1692261512194,1693233776365,242,173,69
373,1693233776365,1692261512232,1692261512403,1693233776575,210,171,39
374,1693233776575,1692261512454,1692261512624,1693233776795,220,170,50
375,1693233776795,1692261512660,1692261512830,1693233777001,206,170,36
376,1693233777001,1692261512871,1692261513041,1693233777212,211,170,41
377,1693233777212,1692261513097,1692261513269,1693233777440,228,172,56
378,1693233777440,1692261513310,1692261513481,1693233777652,212,171,41
379,1693233777652,1692261513498,1692261513668,1693233777839,187,170,17
380,1693233777839,1692261513723,1692261513896,1693233778067,228,173,55
381,1693233778067,1692261513926,1692261514095,1693233778267,200,169,31
382,1693233778267,1692261514144,1692261514316,1693233778487,220,172,48
383,1693233778487,1692261514353,1692261514525,1693233778696,209,172,37
384,1693233778696,1692261514579,1692261514750,1693233778921,225,171,54
385,1693233778921,1692261514825,1692261514996,1693233779166,245,171,74
386,1693233779167,1692261515052,1692261515224,1693233779395,228,172,56
387,1693233779395,1692261515259,1692261515432,1693233779603,208,173,35
388,1693233779603,1692261515489,1692261515660,1693233779831,228,171,57
389,1693233779831,1692261515708,1692261515881,1693233780052,221,173,48
390,1693233780052,1692261515933,1692261516107,1693233780278,226,174,52
391,1693233780278,1692261516143,1692261516313,1693233780484,206,170,36
392,1693233780484,1692261516346,1692261516515,1693233780686,202,169,33
393,1693233780686,1692261516568,1692261516740,1693233780914,228,172,56
394,1693233780914,1692261516784,1692261516954,1693233781125,211,170,41
395,1693233781125,1692261516985,1692261517154,1693233781325,200,169,31
396,1693233781325,1692261517202,1692261517372,1693233781544,219,170,49
397,1693233781544,1692261517419,1692261517592,1693233781763,219,173,46
398,1693233781763,1692261517625,1692261517792,1693233781963,200,167,33
399,1693233781964,1692261517812,1692261517981,1693233782152,188,169,19
400,1693233782152,1692261518040,1692261518213,1693233782383,231,173,58
401,1693233782384,1692261518267,1692261518437,1693233782608,224,170,54
402,1693233782609,1692261518497,1692261518670,1693233782840,231,173,58
403,1693233783012,1692261518886,1692261519132,1693233783372,360,246,114
404,1693233783372,1692261519250,1692261519528,1693233783699,327,278,49
405,1693233783699,1692261519565,1692261519759,1693233783930,231,194,37
406,1693233783930,1692261519809,1692261520143,1693233784396,466,334,132
407,1693233784396,1692261520256,1692261520535,1693233784707,311,279,32
408,1693233784707,1692261520577,1692261520759,1693233784930,223,182,41
409,1693233784930,1692261520806,1692261520980,1693233785151,221,174,47
410,1693233785151,1692261521017,1692261521186,1693233785358,207,169,38
411,1693233785358,1692261521226,1692261521397,1693233785568,210,171,39
412,1693233785568,1692261521431,1692261521601,1693233785772,204,170,34
413,1693233785772,1692261521640,1692261521812,1693233785982,210,172,38
414,1693233785982,1692261521835,1692261522004,1693233786175,193,169,24
415,1693233786175,1692261522052,1692261522223,1693233786394,219,171,48
416,1693233786394,1692261522258,1692261522430,1693233786600,206,172,34
417,1693233786600,1692261522467,1692261522636,1693233786807,207,169,38
418,1693233786807,1692261522702,1692261522875,1693233787046,239,173,66
419,1693233787046,1692261522914,1692261523086,1693233787261,215,172,43
420,1693233787261,1692261523120,1692261523288,1693233787459,198,168,30
421,1693233787459,1692261523334,1692261523506,1693233787677,218,172,46
422,1693233787677,1692261523579,1692261523754,1693233787925,248,175,73
423,1693233787925,1692261523794,1692261523965,1693233788136,211,171,40
424,1693233788136,1692261524022,1692261524193,1693233788364,228,171,57
425,1693233788364,1692261524243,1692261524414,1693233788584,220,171,49
426,1693233788585,1692261524471,1692261524643,1693233788815,230,172,58
427,1693233788815,1692261524689,1692261524861,1693233789031,216,172,44
428,1693233789032,1692261524923,1692261525097,1693233789268,236,174,62
429,1693233789268,1692261525133,1692261525307,1693233789478,210,174,36
430,1693233789478,1692261525358,1692261525530,1693233789701,223,172,51
431,1693233789701,1692261525564,1692261525732,1693233789903,202,168,34
432,1693233789903,1692261525783,1692261525958,1693233790129,226,175,51
433,1693233790130,1692261526021,1692261526192,1693233790363,233,171,62
434,1693233790363,1692261526240,1692261526411,1693233790582,219,171,48
435,1693233790582,1692261526451,1692261526621,1693233790792,210,170,40
436,1693233790792,1692261526666,1692261526838,1693233791008,216,172,44
437,1693233791008,1692261526875,1692261527046,1693233791217,209,171,38
438,1693233791217,1692261527105,1692261527283,1693233791454,237,178,59
439,1693233791454,1692261527334,1692261527511,1693233791682,228,177,51
440,1693233791682,1692261527565,1692261527735,1693233791905,223,170,53
441,1693233791905,1692261527801,1692261527974,1693233792145,240,173,67
442,1693233792145,1692261528006,1692261528180,1693233792368,223,174,49
443,1693233792368,1692261528258,1692261528436,1693233792607,239,178,61
444,1693233792607,1692261528469,1692261528641,1693233792812,205,172,33
445,1693233792812,1692261528695,1692261528869,1693233793041,229,174,55
446,1693233793041,1692261528902,1692261529073,1693233793244,203,171,32
447,1693233793244,1692261529118,1692261529290,1693233793461,217,172,45
448,1693233793461,1692261529349,1692261529519,1693233793690,229,170,59
449,1693233793690,1692261529551,1692261529728,1693233793899,209,177,32
450,1693233793899,1692261529791,1692261529963,1693233794134,235,172,63
451,1693233794134,1692261530003,1692261530172,1693233794343,209,169,40
452,1693233794343,1692261530215,1692261530385,1693233794556,213,170,43
453,1693233794556,1692261530430,1692261530602,1693233794773,217,172,45
454,1693233794774,1692261530637,1692261530806,1693233794977,203,169,34
455,1693233794977,1692261530828,1692261530998,1693233795169,192,170,22
456,1693233795169,1692261531066,1692261531241,1693233795412,243,175,68
457,1693233795412,1692261531309,1692261531480,1693233795651,239,171,68
458,1693233795651,1692261531536,1692261531709,1693233795880,229,173,56
459,1693233795880,1692261531767,1692261531940,1693233796111,231,173,58
460,1693233796111,1692261531994,1692261532166,1693233796336,225,172,53
461,1693233796336,1692261532201,1692261532371,1693233796542,206,170,36
462,1693233796542,1692261532444,1692261532619,1693233796790,248,175,73
463,1693233796790,1692261532686,1692261532857,1693233797027,237,171,66
464,1693233797027,1692261532900,1692261533073,1693233797244,217,173,44
465,1693233797244,1692261533103,1692261533272,1693233797443,199,169,30
466,1693233797443,1692261533345,1692261533517,1693233797688,245,172,73
467,1693233797688,1692261533561,1692261533733,1693233797904,216,172,44
468,1693233797904,1692261533787,1692261533959,1693233798130,226,172,54
469,1693233798130,1692261533991,1692261534163,1693233798334,204,172,32
470,1693233798334,1692261534196,1692261534365,1693233798535,201,169,32
471,1693233798535,1692261534441,1692261534613,1693233798784,249,172,77
472,1693233798784,1692261534651,1692261534825,1693233799036,252,174,78
473,1693233799036,1692261534914,1692261535089,1693233799364,328,175,153
474,1693233799364,1692261535240,1692261535411,1693233799652,288,171,117
475,1693233799652,1692261535527,1692261535698,1693233799984,332,171,161
476,1693233799984,1692261535878,1692261536055,1693233800314,330,177,153
477,1693233800314,1692261536179,1692261536348,1693233800539,225,169,56
478,1693233800540,1692261536417,1692261536590,1693233800761,221,173,48
479,1693233800761,1692261536643,1692261536823,1693233800994,233,180,53
480,1693233800994,1692261536880,1692261537054,1693233801224,230,174,56
481,1693233801224,1692261537104,1692261537275,1693233801472,248,171,77
482,1693233801472,1692261537344,1692261537518,1693233801688,216,174,42
483,1693233801688,1692261537572,1692261537742,1693233801913,225,170,55
484,1693233801913,1692261537774,1692261537942,1693233802113,200,168,32
485,1693233802113,1692261538001,1692261538171,1693233802350,237,170,67
486,1693233802350,1692261538227,1692261538402,1693233802573,223,175,48
487,1693233802573,1692261538450,1692261538622,1693233802792,219,172,47
488,1693233802792,1692261538666,1692261538840,1693233803011,219,174,45
489,1693233803011,1692261538911,1692261539084,1693233803255,244,173,71
490,1693233803255,1692261539126,1692261539297,1693233803468,213,171,42
491,1693233803468,1692261539322,1692261539491,1693233803661,193,169,24
492,1693233803661,1692261539515,1692261539685,1693233803857,196,170,26
493,1693233803857,1692261539738,1692261539910,1693233804080,223,172,51
494,1693233804080,1692261539970,1692261540143,1693233804314,234,173,61
495,1693233804314,1692261540183,1692261540353,1693233804524,210,170,40
496,1693233804524,1692261540412,1692261540583,1693233804754,230,171,59
497,1693233804754,1692261540644,1692261540817,1693233804988,234,173,61
498,1693233804988,1692261540861,1692261541032,1693233805202,214,171,43
499,1693233805202,1692261541069,1692261541242,1693233805413,211,173,38
500,1693233805413,1692261541276,1692261541446,1693233805617,204,170,34
501,1693233805617,1692261541486,1692261541656,1693233805827,210,170,40
502,1693233805827,1692261541695,1692261541874,1693233806048,221,179,42
503,1693233806048,1692261541939,1692261542117,1693233806288,240,178,62
504,1693233806288,1692261542188,1692261542359,1693233806530,242,171,71
505,1693233806530,1692261542404,1692261542575,1693233806745,215,171,44
506,1693233806745,1692261542622,1692261542794,1693233806965,220,172,48
507,1693233806965,1692261542835,1692261543012,1693233807183,218,177,41
508,1693233807183,1692261543038,1692261543222,1693233807392,209,184,25
509,1693233807392,1692261543284,1692261543459,1693233807630,238,175,63
510,1693233807630,1692261543528,1692261543701,1693233807872,242,173,69
511,1693233807872,1692261543751,1692261543928,1693233808099,227,177,50
512,1693233808099,1692261543967,1692261544140,1693233808310,211,173,38
513,1693233808310,1692261544183,1692261544353,1693233808524,214,170,44
514,1693233808524,1692261544380,1692261544551,1693233808722,198,171,27
515,1693233808722,1692261544583,1692261544752,1693233808923,201,169,32
516,1693233808923,1692261544780,1692261544952,1693233809122,199,172,27
517,1693233809122,1692261545028,1692261545202,1693233809373,251,174,77
518,1693233809373,1692261545274,1692261545446,1693233809616,243,172,71
519,1693233809616,1692261545485,1692261545657,1693233809828,212,172,40
520,1693233809828,1692261545703,1692261545874,1693233810045,217,171,46
521,1693233810045,1692261545962,1692261546139,1693233810317,272,177,95
522,1693233810317,1692261546195,1692261546368,1693233810539,222,173,49
523,1693233810539,1692261546412,1692261546584,1693233810754,215,172,43
524,1693233810754,1692261546646,1692261546817,1693233810988,234,171,63
525,1693233810988,1692261546874,1692261547046,1693233811216,228,172,56
526,1693233811216,1692261547086,1692261547259,1693233811430,214,173,41
527,1693233811430,1692261547313,1692261547486,1693233811659,229,173,56
528,1693233811659,1692261547532,1692261547704,1693233811875,216,172,44
529,1693233811875,1692261547748,1692261547920,1693233812092,217,172,45
530,1693233812092,1692261547962,1692261548133,1693233812304,212,171,41
531,1693233812304,1692261548168,1692261548340,1693233812510,206,172,34
532,1693233812511,1692261548369,1692261548539,1693233812710,199,170,29
533,1693233812710,1692261548599,1692261548771,1693233812942,232,172,60
534,1693233812942,1692261548837,1692261549010,1693233813181,239,173,66
535,1693233813187,1692261549060,1692261549232,1693233813403,216,172,44
536,1693233813403,1692261549269,1692261549439,1693233813610,207,170,37
537,1693233813610,1692261549474,1692261549644,1693233813814,204,170,34
538,1693233813814,1692261549724,1692261549898,1693233814068,254,174,80
539,1693233814068,1692261549972,1692261550144,1693233814315,247,172,75
540,1693233814315,1692261550175,1692261550344,1693233814515,200,169,31
541,1693233814515,1692261550382,1692261550552,1693233814723,208,170,38
542,1693233814723,1692261550582,1692261550752,1693233814922,199,170,29
543,1693233814922,1692261550796,1692261550967,1693233815138,216,171,45
544,1693233815138,1692261550994,1692261551163,1693233815334,196,169,27
545,1693233815334,1692261551196,1692261551367,1693233815538,204,171,33
546,1693233815538,1692261551397,1692261551566,1693233815739,201,169,32
547,1693233815739,1692261551638,1692261551812,1693233815982,243,174,69
548,1693233815983,1692261551857,1692261552029,1693233816201,218,172,46
549,1693233816201,1692261552058,1692261552227,1693233816397,196,169,27
550,1693233816397,1692261552269,1692261552440,1693233816610,213,171,42
551,1693233816610,1692261552494,1692261552668,1693233816838,228,174,54
552,1693233816838,1692261552713,1692261552885,1693233817060,222,172,50
553,1693233817060,1692261552945,1692261553116,1693233817287,227,171,56
554,1693233817287,1692261553162,1692261553333,1693233817503,216,171,45
555,1693233817503,1692261553379,1692261553550,1693233817721,218,171,47
556,1693233817721,1692261553583,1692261553752,1693233817923,202,169,33
557,1693233817923,1692261553778,1692261553948,1693233818118,195,170,25
558,1693233818118,1692261553979,1692261554149,1693233818320,202,170,32
559,1693233818320,1692261554196,1692261554366,1693233818537,217,170,47
560,1693233818537,1692261554416,1692261554588,1693233818758,221,172,49
561,1693233818758,1692261554621,1692261554794,1693233818965,207,173,34
562,1693233818965,1692261554814,1692261554982,1693233819190,225,168,57
563,1693233819191,1692261555090,1692261555261,1693233819432,241,171,70
564,1693233819432,1692261555329,1692261555501,1693233819671,239,172,67
565,1693233819671,1692261555559,1692261555731,1693233819902,231,172,59
566,1693233819902,1692261555782,1692261555953,1693233820124,222,171,51
567,1693233820124,1692261556003,1692261556174,1693233820345,221,171,50
568,1693233820345,1692261556229,1692261556402,1693233820573,228,173,55
569,1693233820573,1692261556444,1692261556615,1693233820785,212,171,41
570,1693233820785,1692261556653,1692261556825,1693233820995,210,172,38
571,1693233820995,1692261556856,1692261557026,1693233821196,201,170,31
572,1693233821196,1692261557048,1692261557218,1693233821389,193,170,23
573,1693233821389,1692261557267,1692261557437,1693233821608,219,170,49
574,1693233821608,1692261557523,1692261557695,1693233821866,258,172,86
575,1693233821866,1692261557728,1692261557899,1693233822069,203,171,32
576,1693233822069,1692261557935,1692261558105,1693233822275,206,170,36
577,1693233822275,1692261558142,1692261558313,1693233822487,212,171,41
578,1693233822487,1692261558360,1692261558532,1693233822702,215,172,43
579,1693233822702,1692261558562,1692261558731,1693233822901,199,169,30
580,1693233822901,1692261558792,1692261558965,1693233823135,234,173,61
581,1693233823135,1692261558995,1692261559165,1693233823336,201,170,31
582,1693233823336,1692261559200,1692261559368,1693233823539,203,168,35
583,1693233823539,1692261559413,1692261559584,1693233823755,216,171,45
584,1693233823755,1692261559622,1692261559792,1693233823963,208,170,38
585,1693233823963,1692261559827,1692261559997,1693233824168,205,170,35
586,1693233824168,1692261560047,1692261560220,1693233824390,222,173,49
587,1693233824390,1692261560247,1692261560418,1693233824589,199,171,28
588,1693233824589,1692261560492,1692261560667,1693233824843,254,175,79
589,1693233824843,1692261560764,1692261560935,1693233825106,263,171,92
590,1693233825106,1692261560970,1692261561141,1693233825311,205,171,34
591,1693233825311,1692261561190,1692261561363,1693233825533,222,173,49
592,1693233825533,1692261561410,1692261561580,1693233825751,218,170,48
593,1693233825751,1692261561621,1692261561792,1693233825963,212,171,41
594,1693233825963,1692261561825,1692261561994,1693233826165,202,169,33
595,1693233826165,1692261562048,1692261562220,1693233826390,225,172,53
596,1693233826390,1692261562251,1692261562420,1693233826590,200,169,31
597,1693233826590,1692261562451,1692261562621,1693233826791,201,170,31
598,1693233826791,1692261562665,1692261562837,1693233827008,217,172,45
599,1693233827008,1692261562898,1692261563070,1693233827243,235,172,63
600,1693233827243,1692261563138,1692261563309,1693233827480,237,171,66
601,1693233827480,1692261563354,1692261563525,1693233827695,215,171,44
602,1693233827695,1692261563584,1692261563754,1693233827925,230,170,60
603,1693233827925,1692261563795,1692261563967,1693233828137,212,172,40
604,1693233828137,1692261564025,1692261564196,1693233828367,230,171,59
605,1693233828367,1692261564253,1692261564426,1693233828597,230,173,57
606,1693233828597,1692261564469,1692261564641,1693233828811,214,172,42
607,1693233828811,1692261564677,1692261564847,1693233829018,207,170,37
608,1693233829018,1692261564889,1692261565062,1693233829232,214,173,41
609,1693233829232,1692261565093,1692261565261,1693233829432,200,168,32
610,1693233829432,1692261565322,1692261565493,1693233829663,231,171,60
611,1693233829663,1692261565540,1692261565713,1693233829963,300,173,127
612,1693233829963,1692261565831,1692261566000,1693233830170,207,169,38
613,1693233830170,1692261566050,1692261566222,1693233830393,223,172,51
614,1693233830393,1692261566256,1692261566425,1693233830595,202,169,33
615,1693233830595,1692261566472,1692261566644,1693233830815,220,172,48
616,1693233830815,1692261566679,1692261566849,1693233831019,204,170,34
617,1693233831019,1692261566908,1692261567080,1693233831250,231,172,59
618,1693233831250,1692261567168,1692261567342,1693233831512,262,174,88
619,1693233831513,1692261567368,1692261567538,1693233831708,195,170,25
620,1693233831708,1692261567576,1692261567746,1693233831916,208,170,38
621,1693233831916,1692261567766,1692261567937,1693233832107,191,171,20
622,1693233832107,1692261567964,1692261568132,1693233832303,196,168,28
623,1693233832303,1692261568183,1692261568354,1693233832524,221,171,50
624,1693233832524,1692261568403,1692261568574,1693233832745,221,171,50
625,1693233832745,1692261568623,1692261568795,1693233832965,220,172,48
626,1693233832966,1692261568829,1692261568999,1693233833169,203,170,33
627,1693233833169,1692261569050,1692261569223,1693233833394,225,173,52
628,1693233833394,1692261569260,1692261569431,1693233833602,208,171,37
629,1693233833602,1692261569463,1692261569633,1693233833803,201,170,31
630,1693233833803,1692261569677,1692261569848,1693233834019,216,171,45
631,1693233834019,1692261569879,1692261570049,1693233834220,201,170,31
632,1693233834220,1692261570079,1692261570248,1693233834419,199,169,30
633,1693233834419,1692261570283,1692261570453,1693233834624,205,170,35
634,1693233834624,1692261570486,1692261570654,1693233834824,200,168,32
635,1693233834824,1692261570696,1692261570867,1693233835038,214,171,43
636,1693233835038,1692261570947,1692261571121,1693233835292,254,174,80
637,1693233835292,1692261571182,1692261571354,1693233835524,232,172,60
638,1693233835525,1692261571403,1692261571576,1693233835746,221,173,48
639,1693233835746,1692261571621,1692261571791,1693233835961,215,170,45
640,1693233835961,1692261571854,1692261572026,1693233836196,235,172,63
641,1693233836196,1692261572074,1692261572246,1693233836416,220,172,48
642,1693233836416,1692261572282,1692261572452,1693233836622,206,170,36
643,1693233836622,1692261572484,1692261572654,1693233836827,205,170,35
644,1693233836827,1692261572696,1692261572866,1693233837037,210,170,40
645,1693233837037,1692261572918,1692261573090,1693233837261,224,172,52
646,1693233837261,1692261573129,1692261573299,1693233837469,208,170,38
647,1693233837469,1692261573338,1692261573509,1693233837679,210,171,39
648,1693233837679,1692261573551,1692261573724,1693233837895,216,173,43
649,1693233837895,1692261573757,1692261573927,1693233838098,203,170,33
650,1693233838098,1692261573971,1692261574144,1693233838314,216,173,43
651,1693233838314,1692261574190,1692261574362,1693233838532,218,172,46
652,1693233838532,1692261574399,1692261574570,1693233838740,208,171,37
653,1693233838740,1692261574595,1692261574764,1693233838936,196,169,27
654,1693233838936,1692261574797,1692261574965,1693233839135,199,168,31
655,1693233839136,1692261575022,1692261575196,1693233839367,231,174,57
656,1693233839367,1692261575252,1692261575423,1693233839593,226,171,55
657,1693233839593,1692261575482,1692261575656,1693233839827,234,174,60
658,1693233839827,1692261575687,1692261575858,1693233840028,201,171,30
659,1693233840028,1692261575919,1692261576091,1693233840261,233,172,61
660,1693233840261,1692261576124,1692261576296,1693233840466,205,172,33
661,1693233840466,1692261576358,1692261576531,1693233840701,235,173,62
662,1693233840701,1692261576585,1692261576756,1693233840927,226,171,55
663,1693233840927,1692261576822,1692261576995,1693233841165,238,173,65
664,1693233841166,1692261577042,1692261577213,1693233841383,217,171,46
665,1693233841383,1692261577278,1692261577451,1693233841622,239,173,66
666,1693233841622,1692261577520,1692261577692,1693233841863,241,172,69
667,1693233841863,1692261577739,1692261577912,1693233842082,219,173,46
668,1693233842082,1692261577971,1692261578145,1693233842315,233,174,59
669,1693233842315,1692261578195,1692261578366,1693233842536,221,171,50
670,1693233842536,1692261578412,1692261578583,1693233842753,217,171,46
671,1693233842753,1692261578616,1692261578788,1693233842959,206,172,34
672,1693233842959,1692261578847,1692261579018,1693233843188,229,171,58
673,1693233843361,1692261579243,1692261579615,1693233843787,426,372,54
674,1693233843787,1692261579658,1692261579971,1693233844141,354,313,41
675,1693233844141,1692261580014,1692261580343,1693233844513,372,329,43
676,1693233844513,1692261580380,1692261580720,1693233844890,377,340,37
677,1693233844890,1692261580780,1692261580962,1693233845132,242,182,60
678,1693233845132,1692261581034,1692261581209,1693233845380,248,175,73
679,1693233845380,1692261581250,1692261581421,1693233845591,211,171,40
680,1693233845591,1692261581465,1692261581636,1693233845806,215,171,44
681,1693233845806,1692261581676,1692261581845,1693233846016,210,169,41
682,1693233846016,1692261581884,1692261582054,1693233846224,208,170,38
683,1693233846224,1692261582096,1692261582265,1693233846436,212,169,43
684,1693233846436,1692261582303,1692261582474,1693233846644,208,171,37
685,1693233846644,1692261582510,1692261582679,1693233846850,206,169,37
686,1693233846850,1692261582709,1692261582879,1693233847050,200,170,30
687,1693233847050,1692261582923,1692261583098,1693233847268,218,175,43
688,1693233847268,1692261583140,1692261583312,1693233847482,214,172,42
689,1693233847482,1692261583345,1692261583515,1693233847685,203,170,33
690,1693233847685,1692261583547,1692261583716,1693233847887,202,169,33
691,1693233847887,1692261583768,1692261583939,1693233848109,222,171,51
692,1693233848109,1692261583992,1692261584164,1693233848334,225,172,53
693,1693233848334,1692261584210,1692261584381,1693233848552,218,171,47
694,1693233848552,1692261584433,1692261584605,1693233848775,223,172,51
695,1693233848775,1692261584642,1692261584814,1693233848984,209,172,37
696,1693233848984,1692261584852,1692261585021,1693233849191,207,169,38
697,1693233849191,1692261585068,1692261585241,1693233849411,220,173,47
698,1693233849411,1692261585319,1692261585491,1693233849663,252,172,80
699,1693233849663,1692261585561,1692261585734,1693233849904,241,173,68
700,1693233849904,1692261585776,1692261585949,1693233850119,215,173,42
701,1693233850119,1692261586004,1692261586175,1693233850345,226,171,55
702,1693233850345,1692261586220,1692261586391,1693233850561,216,171,45
703,1693233850561,1692261586436,1692261586608,1693233850778,217,172,45
704,1693233850778,1692261586639,1692261586810,1693233850980,202,171,31
705,1693233850980,1692261586849,1692261587018,1693233851188,208,169,39
706,1693233851188,1692261587066,1692261587241,1693233851411,223,175,48
707,1693233851411,1692261587281,1692261587454,1693233851624,213,173,40
708,1693233851624,1692261587500,1692261587670,1693233851840,216,170,46
709,1693233851840,1692261587731,1692261587909,1693233852080,240,178,62
710,1693233852080,1692261587956,1692261588142,1693233852313,233,186,47
711,1693233852313,1692261588188,1692261588361,1693233852531,218,173,45
712,1693233852531,1692261588394,1692261588574,1693233852745,214,180,34
713,1693233852745,1692261588642,1692261588812,1693233852982,237,170,67
714,1693233852982,1692261588848,1692261589020,1693233853190,208,172,36
715,1693233853190,1692261589073,1692261589252,1693233853422,232,179,53
716,1693233853423,1692261589273,1692261589441,1693233853616,193,168,25
717,1693233853616,1692261589465,1692261589645,1693233853815,199,180,19
718,1693233853815,1692261589702,1692261589877,1693233854047,232,175,57
719,1693233854047,1692261589916,1692261590086,1693233854257,210,170,40
720,1693233854257,1692261590127,1692261590298,1693233854468,211,171,40
721,1693233854468,1692261590334,1692261590505,1693233854675,207,171,36
722,1693233854675,1692261590557,1692261590729,1693233854899,224,172,52
723,1693233854899,1692261590782,1692261590952,1693233855122,223,170,53
724,1693233855122,1692261590992,1692261591165,1693233855335,213,173,40
725,1693233855335,1692261591232,1692261591404,1693233855575,240,172,68
726,1693233855575,1692261591455,1692261591629,1693233855800,225,174,51
727,1693233855800,1692261591653,1692261591824,1693233855994,194,171,23
728,1693233855994,1692261591858,1692261592028,1693233856199,205,170,35
729,1693233856199,1692261592089,1692261592261,1693233856431,232,172,60
730,1693233856431,1692261592304,1692261592476,1693233856646,215,172,43
731,1693233856646,1692261592525,1692261592696,1693233856866,220,171,49
732,1693233856866,1692261592732,1692261592903,1693233857073,207,171,36
733,1693233857073,1692261592935,1692261593106,1693233857276,203,171,32
734,1693233857276,1692261593148,1692261593320,1693233857490,214,172,42
735,1693233857490,1692261593362,1692261593533,1693233857703,213,171,42
736,1693233857703,1692261593584,1692261593756,1693233857926,223,172,51
737,1693233857926,1692261593804,1692261593978,1693233858148,222,174,48
738,1693233858148,1692261594003,1692261594172,1693233858342,194,169,25
739,1693233858343,1692261594224,1692261594396,1693233858566,223,172,51
740,1693233858566,1692261594433,1692261594605,1693233858775,209,172,37
741,1693233858775,1692261594646,1692261594819,1693233858989,214,173,41
742,1693233858990,1692261594885,1692261595057,1693233859228,238,172,66
743,1693233859228,1692261595118,1692261595289,1693233859459,231,171,60
744,1693233859459,1692261595321,1692261595496,1693233859667,208,175,33
745,1693233859667,1692261595527,1692261595700,1693233859870,203,173,30
746,1693233859870,1692261595735,1692261595910,1693233860091,221,175,46
747,1693233860091,1692261595953,1692261596125,1693233860295,204,172,32
748,1693233860295,1692261596175,1692261596346,1693233860516,221,171,50
749,1693233860516,1692261596389,1692261596560,1693233860730,214,171,43
750,1693233860730,1692261596597,1692261596768,1693233860938,208,171,37
751,1693233860938,1692261596837,1692261597009,1693233861180,242,172,70
752,1693233861180,1692261597071,1692261597248,1693233861418,238,177,61
753,1693233861418,1692261597305,1692261597476,1693233861647,229,171,58
754,1693233861647,1692261597520,1692261597693,1693233861864,217,173,44
755,1693233861864,1692261597726,1692261597895,1693233862065,201,169,32
756,1693233862066,1692261597956,1692261598127,1693233862297,231,171,60
757,1693233862297,1692261598210,1692261598384,1693233862554,257,174,83
758,1693233862555,1692261598430,1692261598600,1693233862770,215,170,45
759,1693233862770,1692261598629,1692261598799,1693233862969,199,170,29
760,1693233862969,1692261598837,1692261599006,1693233863176,207,169,38
761,1693233863176,1692261599072,1692261599242,1693233863419,243,170,73
762,1693233863419,1692261599389,1692261599562,1693233863735,316,173,143
763,1693233863735,1692261599655,1692261599828,1693233864001,266,173,93
764,1693233864001,1692261599889,1692261600061,1693233864232,231,172,59
765,1693233864232,1692261600120,1692261600289,1693233864459,227,169,58
766,1693233864459,1692261600358,1692261600531,1693233864701,242,173,69
767,1693233864701,1692261600606,1692261600780,1693233864950,249,174,75
768,1693233864950,1692261600864,1692261601036,1693233865206,256,172,84
769,1693233865206,1692261601090,1692261601261,1693233865432,226,171,55
770,1693233865432,1692261601286,1692261601456,1693233865626,194,170,24
771,1693233865626,1692261601531,1692261601706,1693233865878,252,175,77
772,1693233865879,1692261601764,1692261601940,1693233866112,233,176,57
773,1693233866112,1692261601999,1692261602170,1693233866340,228,171,57
774,1693233866340,1692261602215,1692261602387,1693233866557,217,172,45
775,1693233866558,1692261602420,1692261602596,1693233866766,208,176,32
776,1693233866766,1692261602639,1692261602821,1693233866995,229,182,47
777,1693233866995,1692261602896,1692261603078,1693233867249,254,182,72
778,1693233867249,1692261603144,1692261603315,1693233867485,236,171,65
779,1693233867485,1692261603355,1692261603526,1693233867698,213,171,42
780,1693233867699,1692261603571,1692261603742,1693233867912,213,171,42
781,1693233867912,1692261603822,1692261603994,1693233868168,256,172,84
782,1693233868168,1692261604056,1692261604230,1693233868400,232,174,58
783,1693233868400,1692261604289,1692261604459,1693233868632,232,170,62
784,1693233868632,1692261604533,1692261604706,1693233868876,244,173,71
785,1693233868876,1692261604772,1692261604943,1693233869115,239,171,68
786,1693233869115,1692261605020,1692261605195,1693233869365,250,175,75
787,1693233869365,1692261605302,1692261605475,1693233869649,284,173,111
788,1693233869649,1692261605554,1692261605725,1693233869901,252,171,81
789,1693233869901,1692261605844,1692261606015,1693233870185,284,171,113
790,1693233870185,1692261606099,1692261606272,1693233870443,258,173,85
791,1693233870443,1692261606329,1692261606500,1693233870670,227,171,56
792,1693233870670,1692261606538,1692261606708,1693233870878,208,170,38
793,1693233870878,1692261606737,1692261606906,1693233871076,198,169,29
794,1693233871076,1692261606976,1692261607148,1693233871319,243,172,71
795,1693233871319,1692261607221,1692261607392,1693233871562,243,171,72
796,1693233871562,1692261607435,1692261607607,1693233871776,214,172,42
797,1693233871777,1692261607655,1692261607826,1693233871998,221,171,50
798,1693233871998,1692261607888,1692261608061,1693233872231,233,173,60
799,1693233872231,1692261608099,1692261608268,1693233872438,207,169,38
800,1693233872438,1692261608323,1692261608494,1693233872664,226,171,55
801,1693233872664,1692261608542,1692261608712,1693233872882,218,170,48
802,1693233872882,1692261608755,1692261608925,1693233873096,214,170,44
803,1693233873096,1692261609003,1692261609172,1693233873348,252,169,83
804,1693233873348,1692261609237,1692261609409,1693233873585,237,172,65
805,1693233873597,1692261609480,1692261609652,1693233873822,225,172,53
806,1693233873822,1692261609716,1692261609888,1693233874058,236,172,64
807,1693233874058,1692261609939,1692261610109,1693233874280,222,170,52
808,1693233874280,1692261610154,1692261610326,1693233874496,216,172,44
809,1693233874496,1692261610383,1692261610555,1693233874733,237,172,65
810,1693233874733,1692261610586,1692261610753,1693233874928,195,167,28
811,1693233874928,1692261610788,1692261610956,1693233875129,201,168,33
812,1693233875129,1692261611026,1692261611196,1693233875366,237,170,67
813,1693233875366,1692261611249,1692261611420,1693233875591,225,171,54
814,1693233875591,1692261611487,1692261611658,1693233875828,237,171,66
815,1693233875828,1692261611713,1692261611886,1693233876057,229,173,56
816,1693233876058,1692261611954,1692261612127,1693233876298,240,173,67
817,1693233876298,1692261612170,1692261612343,1693233876513,215,173,42
818,1693233876513,1692261612408,1692261612580,1693233876750,237,172,65
819,1693233876750,1692261612626,1692261612798,1693233876968,218,172,46
820,1693233876968,1692261612882,1692261613053,1693233877230,262,171,91
821,1693233877230,1692261613116,1692261613287,1693233877462,232,171,61
822,1693233877462,1692261613369,1692261613540,1693233877711,249,171,78
823,1693233877711,1692261613621,1692261613793,1693233877963,252,172,80
824,1693233877963,1692261613854,1692261614025,1693233878197,234,171,63
825,1693233878197,1692261614116,1692261614288,1693233878461,264,172,92
826,1693233878461,1692261614347,1692261614520,1693233878694,233,173,60
827,1693233878694,1692261614629,1692261614799,1693233878973,279,170,109
828,1693233878973,1692261614868,1692261615041,1693233879216,243,173,70
829,1693233879216,1692261615116,1692261615288,1693233879462,246,172,74
830,1693233879462,1692261615363,1692261615534,1693233879715,253,171,82
831,1693233879715,1692261615667,1692261615838,1693233880010,295,171,124
832,1693233880010,1692261616000,1692261616171,1693233880343,333,171,162
833,1693233880343,1692261616190,1692261616358,1693233880528,185,168,17
834,1693233880528,1692261616415,1692261616586,1693233880760,232,171,61
835,1693233880760,1692261616649,1692261616821,1693233880993,233,172,61
836,1693233880993,1692261616956,1692261617129,1693233881299,306,173,133
837,1693233881299,1692261617217,1692261617389,1693233881560,261,172,89
838,1693233881560,1692261617435,1692261617605,1693233881776,216,170,46
839,1693233881776,1692261617665,1692261617837,1693233882006,230,172,58
840,1693233882006,1692261617901,1692261618072,1693233882242,236,171,65
841,1693233882242,1692261618131,1692261618302,1693233882472,230,171,59
842,1693233882472,1692261618361,1692261618531,1693233882700,228,170,58
843,1693233882700,1692261618580,1692261618752,1693233882922,222,172,50
844,1693233882922,1692261618821,1692261618993,1693233883163,241,172,69
845,1693233883163,1692261619050,1692261619222,1693233883392,229,172,57
846,1693233883392,1692261619283,1692261619456,1693233883626,234,173,61
847,1693233883626,1692261619494,1692261619663,1693233883833,207,169,38
848,1693233883833,1692261619768,1692261619940,1693233884110,277,172,105
849,1693233884110,1692261619998,1692261620170,1693233884341,231,172,59
850,1693233884341,1692261620229,1692261620399,1693233884569,228,170,58
851,1693233884569,1692261620454,1692261620625,1693233884795,226,171,55
852,1693233884795,1692261620661,1692261620830,1693233884999,204,169,35
853,1693233884999,1692261620891,1692261621062,1693233885232,233,171,62
854,1693233885232,1692261621149,1692261621321,1693233885490,258,172,86
855,1693233885490,1692261621412,1692261621588,1693233885758,268,176,92
856,1693233885758,1692261621656,1692261621828,1693233885998,240,172,68
857,1693233885998,1692261621893,1692261622064,1693233886235,237,171,66
858,1693233886235,1692261622119,1692261622290,1693233886460,225,171,54
859,1693233886460,1692261622330,1692261622502,1693233886673,213,172,41
860,1693233886673,1692261622564,1692261622734,1693233886904,231,170,61
861,1693233886904,1692261622843,1692261623014,1693233887192,288,171,117
862,1693233887192,1692261623094,1692261623266,1693233887439,247,172,75
863,1693233887440,1692261623330,1692261623506,1693233887676,236,176,60
864,1693233887676,1692261623571,1692261623742,1693233887912,236,171,65
865,1693233887912,1692261623777,1692261623947,1693233888117,205,170,35
866,1693233888117,1692261623998,1692261624172,1693233888342,225,174,51
867,1693233888343,1692261624215,1692261624385,1693233888557,214,170,44
868,1693233888558,1692261624452,1692261624623,1693233888793,235,171,64
869,1693233888793,1692261624667,1692261624838,1693233889008,215,171,44
870,1693233889008,1692261624914,1692261625085,1693233889255,247,171,76
871,1693233889256,1692261625174,1692261625345,1693233889523,267,171,96
872,1693233889523,1692261625410,1692261625579,1693233889755,232,169,63
873,1693233889755,1692261625652,1692261625825,1693233890096,341,173,168
874,1693233890096,1692261625977,1692261626148,1693233890318,222,171,51
875,1693233890318,1692261626213,1692261626384,1693233890554,236,171,65
876,1693233890555,1692261626462,1692261626635,1693233890805,250,173,77
877,1693233890805,1692261626730,1692261626901,1693233891071,266,171,95
878,1693233891071,1692261626953,1692261627123,1693233891293,222,170,52
879,1693233891293,1692261627203,1692261627375,1693233891544,251,172,79
880,1693233891544,1692261627430,1692261627602,1693233891771,227,172,55
881,1693233891771,1692261627661,1692261627832,1693233892001,230,171,59
882,1693233892001,1692261627897,1692261628069,1693233892238,237,172,65
883,1693233892238,1692261628135,1692261628307,1693233892477,239,172,67
884,1693233892477,1692261628392,1692261628564,1693233892737,260,172,88
885,1693233892737,1692261628622,1692261628795,1693233892965,228,173,55
886,1693233892965,1692261628893,1692261629066,1693233893237,272,173,99
887,1693233893237,1692261629157,1692261629328,1693233893498,261,171,90
888,1693233893498,1692261629394,1692261629565,1693233893734,236,171,65
889,1693233893734,1692261629628,1692261629800,1693233893969,235,172,63
890,1693233893969,1692261629850,1692261630020,1693233894190,221,170,51
891,1693233894190,1692261630050,1692261630217,1693233894387,197,167,30
892,1693233894387,1692261630357,1692261630528,1693233894701,314,171,143
893,1693233894701,1692261630616,1692261630786,1693233894956,255,170,85
894,1693233894956,1692261630858,1692261631029,1693233895200,244,171,73
895,1693233895200,1692261631090,1692261631263,1693233895437,237,173,64
896,1693233895437,1692261631292,1692261631465,1693233895636,199,173,26
897,1693233895636,1692261631520,1692261631690,1693233895860,224,170,54
898,1693233895861,1692261631773,1692261631944,1693233896116,255,171,84
899,1693233896116,1692261631983,1692261632153,1693233896323,207,170,37
900,1693233896323,1692261632195,1692261632365,1693233896535,212,170,42
901,1693233896535,1692261632421,1692261632591,1693233896761,226,170,56
902,1693233896761,1692261632637,1692261632807,1693233896977,216,170,46
903,1693233896977,1692261632874,1692261633046,1693233897216,239,172,67
904,1693233897216,1692261633108,1692261633279,1693233897449,233,171,62
905,1693233897449,1692261633352,1692261633525,1693233897695,246,173,73
906,1693233897695,1692261633588,1692261633760,1693233897930,235,172,63
907,1693233897930,1692261633861,1692261634033,1693233898202,272,172,100
908,1693233898202,1692261634082,1692261634253,1693233898423,221,171,50
909,1693233898423,1692261634287,1692261634457,1693233898633,210,170,40
910,1693233898633,1692261634592,1692261634763,1693233898934,301,171,130
911,1693233898934,1692261634818,1692261634988,1693233899159,225,170,55
912,1693233899159,1692261635075,1692261635245,1693233899421,262,170,92
913,1693233899421,1692261635438,1692261635612,1693233899786,365,174,191
914,1693233899786,1692261635721,1692261635892,1693233900066,280,171,109
915,1693233900066,1692261636010,1692261636182,1693233900351,285,172,113
916,1693233900351,1692261636318,1692261636490,1693233900661,310,172,138
917,1693233900661,1692261636592,1692261636764,1693233900934,273,172,101
918,1693233900934,1692261636818,1692261636988,1693233901158,224,170,54
919,1693233901158,1692261637056,1692261637227,1693233901397,239,171,68
920,1693233901397,1692261637300,1692261637470,1693233901640,243,170,73
921,1693233901640,1692261637541,1692261637712,1693233901883,243,171,72
922,1693233901883,1692261637781,1692261637951,1693233902120,237,170,67
923,1693233902120,1692261638011,1692261638183,1693233902356,236,172,64
924,1693233902356,1692261638248,1692261638419,1693233902588,232,171,61
925,1693233902589,1692261638506,1692261638679,1693233902849,260,173,87
926,1693233902849,1692261638742,1692261638914,1693233903084,235,172,63
927,1693233903084,1692261638965,1692261639134,1693233903304,220,169,51
928,1693233903304,1692261639175,1692261639346,1693233903515,211,171,40
929,1693233903515,1692261639408,1692261639579,1693233903749,234,171,63
930,1693233903918,1692261639857,1692261640211,1693233904381,463,354,109
931,1693233904381,1692261640270,1692261640592,1693233904761,380,322,58
932,1693233904761,1692261640629,1692261640930,1693233905099,338,301,37
933,1693233905099,1692261640972,1692261641306,1693233905476,377,334,43
934,1693233905476,1692261641355,1692261641600,1693233905770,294,245,49
935,1693233905770,1692261641702,1692261641874,1693233906044,274,172,102
936,1693233906044,1692261641954,1692261642124,1693233906294,250,170,80
937,1693233906294,1692261642171,1692261642344,1693233906514,220,173,47
938,1693233906514,1692261642437,1692261642610,1693233906781,267,173,94
939,1693233906781,1692261642654,1692261642824,1693233906993,212,170,42
940,1693233906993,1692261642869,1692261643040,1693233907210,217,171,46
941,1693233907210,1692261643137,1692261643308,1693233907482,272,171,101
942,1693233907482,1692261643366,1692261643538,1693233907709,227,172,55
943,1693233907709,1692261643585,1692261643755,1693233907926,217,170,47
944,1693233907926,1692261643834,1692261644007,1693233908177,251,173,78
945,1693233908177,1692261644044,1692261644215,1693233908385,208,171,37
946,1693233908385,1692261644273,1692261644444,1693233908614,229,171,58
947,1693233908614,1692261644488,1692261644660,1693233908830,216,172,44
948,1693233908830,1692261644769,1692261644940,1693233909119,289,171,118
949,1693233909119,1692261645014,1692261645185,1693233909355,236,171,65
950,1693233909355,1692261645249,1692261645420,1693233909591,236,171,65
951,1693233909591,1692261645483,1692261645652,1693233909821,230,169,61
952,1693233909821,1692261645736,1692261645909,1693233910080,259,173,86
953,1693233910080,1692261645967,1692261646140,1693233910310,230,173,57
954,1693233910310,1692261646203,1692261646375,1693233910551,241,172,69
955,1693233910551,1692261646415,1692261646586,1693233910759,208,171,37
956,1693233910759,1692261646685,1692261646858,1693233911029,270,173,97
957,1693233911029,1692261646918,1692261647089,1693233911259,230,171,59
958,1693233911259,1692261647170,1692261647342,1693233911512,253,172,81
959,1693233911512,1692261647397,1692261647568,1693233911737,225,171,54
960,1693233911737,1692261647642,1692261647814,1693233911983,246,172,74
961,1693233911983,1692261647892,1692261648062,1693233912232,249,170,79
962,1693233912232,1692261648114,1692261648286,1693233912458,226,172,54
963,1693233912458,1692261648317,1692261648492,1693233912662,204,175,29
964,1693233912662,1692261648565,1692261648737,1693233912909,247,172,75
965,1693233912909,1692261648804,1692261648981,1693233913150,241,177,64
966,1693233913150,1692261649034,1692261649345,1693233913545,395,311,84
967,1693233913545,1692261649471,1692261649810,1693233913980,435,339,96
968,1693233913980,1692261649871,1692261650083,1693233914252,272,212,60
969,1693233914252,1692261650144,1692261650316,1693233914486,234,172,62
970,1693233914486,1692261650391,1692261650562,1693233914731,245,171,74
971,1693233914731,1692261650661,1692261650834,1693233915003,272,173,99
972,1693233915003,1692261650916,1692261651088,1693233915263,260,172,88
973,1693233915264,1692261651186,1692261651359,1693233915528,264,173,91
974,1693233915528,1692261651434,1692261651609,1693233915779,251,175,76
975,1693233915779,1692261651690,1692261651863,1693233916032,253,173,80
976,1693233916032,1692261651890,1692261652061,1693233916230,198,171,27
977,1693233916230,1692261652148,1692261652320,1693233916490,260,172,88
978,1693233916490,1692261652375,1692261652546,1693233916716,226,171,55
979,1693233916716,1692261652612,1692261652782,1693233916952,236,170,66
980,1693233916952,1692261652870,1692261653041,1693233917211,259,171,88
981,1693233917211,1692261653097,1692261653267,1693233917436,225,170,55
982,1693233917436,1692261653335,1692261653507,1693233917678,242,172,70
983,1693233917678,1692261653612,1692261653784,1693233917955,277,172,105
984,1693233917955,1692261653853,1692261654027,1693233918196,241,174,67
985,1693233918196,1692261654107,1692261654279,1693233918449,253,172,81
986,1693233918449,1692261654323,1692261654495,1693233918665,216,172,44
987,1693233918665,1692261654620,1692261654791,1693233918961,296,171,125
988,1693233918961,1692261654881,1692261655054,1693233919225,264,173,91
989,1693233919225,1692261655119,1692261655289,1693233919465,240,170,70
990,1693233919465,1692261655400,1692261655570,1693233919745,280,170,110
991,1693233919745,1692261655678,1692261655849,1693233920101,356,171,185
992,1693233920101,1692261656016,1692261656187,1693233920359,258,171,87
993,1693233920360,1692261656247,1692261656422,1693233920594,234,175,59
994,1693233920594,1692261656474,1692261656652,1693233920822,228,178,50
995,1693233920822,1692261656707,1692261656883,1693233921062,240,176,64
996,1693233921062,1692261656947,1692261657120,1693233921290,228,173,55
997,1693233921290,1692261657151,1692261657330,1693233921499,209,179,30
998,1693233921499,1692261657397,1692261657731,1693233921900,401,334,67
999,1693233921900,1692261657785,1692261657956,1693233922128,228,171,57
1000,1693233922128,1692261658035,1692261658208,1693233922378,250,173,77
1001,1693233922378,1692261658271,1692261658442,1693233922612,234,171,63
1002,1693233922612,1692261658500,1692261658672,1693233922842,230,172,58
1003,1693233922842,1692261658728,1692261658899,1693233923070,228,171,57
1004,1693233923070,1692261658965,1692261659138,1693233923309,239,173,66
1005,1693233923309,1692261659197,1692261659369,1693233923538,229,172,57
1006,1693233923538,1692261659418,1692261659587,1693233923758,220,169,51
1007,1693233923758,1692261659616,1692261659785,1693233923954,196,169,27
1008,1693233923954,1692261659838,1692261660009,1693233924178,224,171,53
1009,1693233924178,1692261660054,1692261660225,1693233924394,216,171,45
1010,1693233924394,1692261660298,1692261660469,1693233924639,245,171,74
1011,1693233924639,1692261660539,1692261660709,1693233924879,240,170,70
1012,1693233924879,1692261660763,1692261660935,1693233925108,229,172,57
1013,1693233925108,1692261661071,1692261661243,1693233925413,305,172,133
1014,1693233925413,1692261661280,1692261661451,1693233925620,207,171,36
1015,1693233925620,1692261661532,1692261661705,1693233925875,255,173,82
1016,1693233925875,1692261661779,1692261661949,1693233926125,250,170,80
1017,1693233926125,1692261662031,1692261662203,1693233926372,247,172,75
1018,1693233926372,1692261662276,1692261662449,1693233926619,247,173,74
1019,1693233926619,1692261662531,1692261662703,1693233926873,254,172,82
1020,1693233926873,1692261662793,1692261662965,1693233927160,287,172,115
1021,1693233927160,1692261663062,1692261663232,1693233927412,252,170,82
1022,1693233927412,1692261663297,1692261663472,1693233927642,230,175,55
1023,1693233927642,1692261663530,1692261663713,1693233927882,240,183,57
1024,1693233927882,1692261663746,1692261663922,1693233928091,209,176,33
1025,1693233928091,1692261664003,1692261664181,1693233928353,262,178,84
1026,1693233928353,1692261664245,1692261664419,1693233928590,237,174,63
1027,1693233928590,1692261664471,1692261664643,1693233928813,223,172,51
1028,1693233928813,1692261664746,1692261665051,1693233929223,410,305,105
1029,1693233929223,1692261665166,1692261665338,1693233929507,284,172,112
1030,1693233929507,1692261665444,1692261665615,1693233929793,286,171,115
1031,1693233929793,1692261665693,1692261665863,1693233930040,247,170,77
1032,1693233930040,1692261665927,1692261666097,1693233930271,231,170,61
1033,1693233930271,1692261666161,1692261666332,1693233930502,231,171,60
1034,1693233930502,1692261666394,1692261666567,1693233930737,235,173,62
1035,1693233930737,1692261666628,1692261666803,1693233930972,235,175,60
1036,1693233930972,1692261666847,1692261667017,1693233931186,214,170,44
1037,1693233931186,1692261667063,1692261667234,1693233931403,217,171,46
1038,1693233931403,1692261667280,1692261667451,1693233931622,219,171,48
1039,1693233931622,1692261667536,1692261667707,1693233931876,254,171,83
1040,1693233931876,1692261667752,1692261667925,1693233932095,219,173,46
1041,1693233932095,1692261667974,1692261668145,1693233932314,219,171,48
1042,1693233932314,1692261668212,1692261668384,1693233932555,241,172,69
1043,1693233932555,1692261668464,1692261668636,1693233932805,250,172,78
1044,1693233932805,1692261668709,1692261668881,1693233933051,246,172,74
1045,1693233933051,1692261668962,1692261669136,1693233933306,255,174,81
1046,1693233933306,1692261669214,1692261669385,1693233933555,249,171,78
1047,1693233933555,1692261669427,1692261669597,1693233933766,211,170,41
1048,1693233933766,1692261669673,1692261669846,1693233934015,249,173,76
1049,1693233934022,1692261669906,1692261670077,1693233934246,224,171,53
1050,1693233934247,1692261670125,1692261670297,1693233934466,219,172,47
1051,1693233934466,1692261670372,1692261670545,1693233934715,249,173,76
1052,1693233934715,1692261670623,1692261670795,1693233934966,251,172,79
1053,1693233934966,1692261670843,1692261671015,1693233935185,219,172,47
1054,1693233935185,1692261671075,1692261671247,1693233935420,235,172,63
1055,1693233935420,1692261671322,1692261671493,1693233935662,242,171,71
1056,1693233935662,1692261671602,1692261671773,1693233935944,282,171,111
1057,1693233935944,1692261671854,1692261672027,1693233936196,252,173,79
1058,1693233936196,1692261672111,1692261672282,1693233936455,259,171,88
1059,1693233936455,1692261672378,1692261672551,1693233936720,265,173,92
1060,1693233936720,1692261672606,1692261672777,1693233936947,227,171,56
1061,1693233936947,1692261672821,1692261672993,1693233937162,215,172,43
1062,1693233937162,1692261673060,1692261673232,1693233937403,241,172,69
1063,1693233937403,1692261673295,1692261673467,1693233937637,234,172,62
1064,1693233937637,1692261673550,1692261673724,1693233937893,256,174,82
1065,1693233937893,1692261673751,1692261673920,1693233938104,211,169,42
1066,1693233938104,1692261673987,1692261674159,1693233938328,224,172,52
1067,1693233938328,1692261674190,1692261674359,1693233938528,200,169,31
1068,1693233938529,1692261674425,1692261674597,1693233938767,238,172,66
1069,1693233938767,1692261674656,1692261674826,1693233939002,235,170,65
1070,1693233939002,1692261674898,1692261675068,1693233939238,236,170,66
1071,1693233939238,1692261675129,1692261675302,1693233939471,233,173,60
1072,1693233939471,1692261675343,1692261675513,1693233939694,223,170,53
1073,1693233939694,1692261675577,1692261675752,1693233939921,227,175,52
1074,1693233939921,1692261675858,1692261676029,1693233940201,280,171,109
1075,1693233940201,1692261676198,1692261676371,1693233940540,339,173,166
1076,1693233940540,1692261676427,1692261676597,1693233940766,226,170,56
1077,1693233940766,1692261676660,1692261676834,1693233941003,237,174,63
1078,1693233941003,1692261676917,1692261677089,1693233941259,256,172,84
1079,1693233941259,1692261677152,1692261677326,1693233941497,238,174,64
1080,1693233941497,1692261677384,1692261677554,1693233941723,226,170,56
1081,1693233941723,1692261677650,1692261677826,1693233941997,274,176,98
1082,1693233941998,1692261677873,1692261678045,1693233942214,216,172,44
1083,1693233942214,1692261678123,1692261678296,1693233942470,256,173,83
1084,1693233942470,1692261678397,1692261678570,1693233942739,269,173,96
1085,1693233942739,1692261678632,1692261678804,1693233942974,235,172,63
1086,1693233942974,1692261678853,1692261679024,1693233943195,221,171,50
1087,1693233943195,1692261679110,1692261679284,1693233943454,259,174,85
1088,1693233943454,1692261679338,1692261679509,1693233943679,225,171,54
1089,1693233943679,1692261679587,1692261679760,1693233943930,251,173,78
1090,1693233943930,1692261679823,1692261679994,1693233944165,235,171,64
1091,1693233944165,1692261680042,1692261680215,1693233944384,219,173,46
1092,1693233944384,1692261680274,1692261680446,1693233944617,233,172,61
1093,1693233944617,1692261680492,1692261680664,1693233944833,216,172,44
1094,1693233944833,1692261680703,1692261680875,1693233945045,212,172,40
1095,1693233945045,1692261680947,1692261681120,1693233945289,244,173,71
1096,1693233945289,1692261681172,1692261681344,1693233945513,224,172,52
1097,1693233945514,1692261681432,1692261681607,1693233945780,266,175,91
1098,1693233945780,1692261681670,1692261681840,1693233946016,236,170,66
1099,1693233946016,1692261681904,1692261682075,1693233946245,229,171,58
1100,1693233946245,1692261682124,1692261682294,1693233946463,218,170,48
1101,1693233946463,1692261682322,1692261682493,1693233946662,199,171,28
1102,1693233946662,1692261682537,1692261682708,1693233946878,216,171,45
1103,1693233946878,1692261682747,1692261682918,1693233947087,209,171,38
1104,1693233947087,1692261682975,1692261683150,1693233947319,232,175,57
1105,1693233947319,1692261683182,1692261683350,1693233947519,200,168,32
1106,1693233947520,1692261683398,1692261683569,1693233947738,218,171,47
1107,1693233947738,1692261683623,1692261683795,1693233947965,227,172,55
1108,1693233947965,1692261683852,1692261684022,1693233948191,226,170,56
1109,1693233948191,1692261684078,1692261684249,1693233948418,227,171,56
1110,1693233948419,1692261684300,1692261684472,1693233948649,230,172,58
1111,1693233948649,1692261684587,1692261684760,1693233948931,282,173,109
1112,1693233948931,1692261684833,1692261685005,1693233949175,244,172,72
1113,1693233949177,1692261685074,1692261685246,1693233949439,262,172,90
1114,1693233949439,1692261685367,1692261685542,1693233949711,272,175,97
1115,1693233949711,1692261685597,1692261685770,1693233949956,245,173,72
1116,1693233949956,1692261685821,1692261685994,1693233950162,206,173,33
1117,1693233950162,1692261686016,1692261686188,1693233950357,195,172,23
1118,1693233950357,1692261686212,1692261686382,1693233950551,194,170,24
1119,1693233950551,1692261686424,1692261686593,1693233950761,210,169,41
1120,1693233950761,1692261686622,1692261686790,1693233950959,198,168,30
1121,1693233950959,1692261686836,1692261687006,1693233951175,216,170,46
1122,1693233951175,1692261687042,1692261687212,1693233951380,205,170,35
1123,1693233951380,1692261687264,1692261687438,1693233951612,232,174,58
1124,1693233951612,1692261687481,1692261687654,1693233951822,210,173,37
1125,1693233951822,1692261687698,1692261687868,1693233952037,215,170,45
1126,1693233952037,1692261687922,1692261688094,1693233952263,226,172,54
1127,1693233952263,1692261688130,1692261688301,1693233952470,207,171,36
1128,1693233952470,1692261688361,1692261688534,1693233952703,233,173,60
1129,1693233952704,1692261688567,1692261688736,1693233952905,201,169,32
1130,1693233952905,1692261688772,1692261688941,1693233953110,205,169,36
1131,1693233953110,1692261688983,1692261689153,1693233953322,212,170,42
1132,1693233953322,1692261689196,1692261689369,1693233953538,216,173,43
1133,1693233953538,1692261689426,1692261689599,1693233953768,230,173,57
1134,1693233953768,1692261689631,1692261689802,1693233953972,204,171,33
1135,1693233953972,1692261689836,1692261690006,1693233954175,203,170,33
1136,1693233954175,1692261690034,1692261690203,1693233954375,200,169,31
1137,1693233954375,1692261690257,1692261690428,1693233954600,225,171,54
1138,1693233954600,1692261690461,1692261690629,1693233954798,198,168,30
1139,1693233954798,1692261690669,1692261690838,1693233955007,209,169,40
1140,1693233955007,1692261690899,1692261691071,1693233955240,233,172,61
1141,1693233955240,1692261691105,1692261691276,1693233955445,205,171,34
1142,1693233955446,1692261691325,1692261691495,1693233955664,218,170,48
1143,1693233955664,1692261691528,1692261691698,1693233955867,203,170,33
1144,1693233955867,1692261691756,1692261691930,1693233956099,232,174,58
1145,1693233956099,1692261691988,1692261692160,1693233956329,230,172,58
1146,1693233956330,1692261692198,1692261692368,1693233956537,207,170,37
1147,1693233956537,1692261692410,1692261692582,1693233956751,214,172,42
1148,1693233956751,1692261692616,1692261692784,1693233956953,202,168,34
1149,1693233956953,1692261692818,1692261692986,1693233957155,202,168,34
1150,1693233957155,1692261693041,1692261693212,1693233957381,226,171,55
1151,1693233957381,1692261693257,1692261693429,1693233957598,217,172,45
1152,1693233957598,1692261693482,1692261693655,1693233957824,226,173,53
1153,1693233957824,1692261693688,1692261693858,1693233958028,204,170,34
1154,1693233958028,1692261693897,1692261694068,1693233958237,209,171,38
1155,1693233958237,1692261694126,1692261694296,1693233958465,228,170,58
1156,1693233958465,1692261694340,1692261694511,1693233958681,216,171,45
1157,1693233958682,1692261694552,1692261694725,1693233958894,212,173,39
1158,1693233958894,1692261694777,1692261694946,1693233959115,221,169,52
1159,1693233959115,1692261694991,1692261695163,1693233959333,218,172,46
1160,1693233959333,1692261695188,1692261695358,1693233959527,194,170,24
1161,1693233959527,1692261695394,1692261695564,1693233959733,206,170,36
1162,1693233959733,1692261695596,1692261695766,1693233959935,202,170,32
1163,1693233959935,1692261695798,1692261695969,1693233960138,203,171,32
1164,1693233960138,1692261696008,1692261696178,1693233960347,209,170,39
1165,1693233960347,1692261696219,1692261696391,1693233960562,215,172,43
1166,1693233960562,1692261696416,1692261696585,1693233960754,192,169,23
1167,1693233960754,1692261696629,1692261696800,1693233960968,214,171,43
1168,1693233960969,1692261696847,1692261697017,1693233961186,217,170,47
1169,1693233961186,1692261697065,1692261697238,1693233961407,221,173,48
1170,1693233961407,1692261697280,1692261697449,1693233961618,211,169,42
1171,1693233961618,1692261697495,1692261697668,1693233961837,219,173,46
1172,1693233961837,1692261697717,1692261697890,1693233962059,222,173,49
1173,1693233962059,1692261697933,1692261698105,1693233962274,215,172,43
1174,1693233962274,1692261698129,1692261698300,1693233962469,195,171,24
1175,1693233962469,1692261698332,1692261698501,1693233962670,201,169,32
1176,1693233962670,1692261698542,1692261698713,1693233962883,213,171,42
1177,1693233962883,1692261698773,1692261698947,1693233963115,232,174,58
1178,1693233963115,1692261698995,1692261699166,1693233963335,220,171,49
1179,1693233963335,1692261699227,1692261699400,1693233963568,233,173,60
1180,1693233963569,1692261699445,1692261699616,1693233963785,216,171,45
1181,1693233963785,1692261699654,1692261699824,1693233963993,208,170,38
1182,1693233963993,1692261699873,1692261700046,1693233964217,224,173,51
1183,1693233964388,1692261700261,1692261700633,1693233964823,435,372,63
1184,1693233964823,1692261700700,1692261701024,1693233965194,371,324,47
1185,1693233965194,1692261701091,1692261701338,1693233965540,346,247,99
1186,1693233965540,1692261701431,1692261701757,1693233965926,386,326,60
1187,1693233965926,1692261701814,1692261701995,1693233966164,238,181,57
1188,1693233966164,1692261702044,1692261702220,1693233966389,225,176,49
1189,1693233966389,1692261702250,1692261702420,1693233966589,200,170,30
1190,1693233966589,1692261702470,1692261702644,1693233966813,224,174,50
1191,1693233966813,1692261702693,1692261702863,1693233967032,219,170,49
1192,1693233967032,1692261702905,1692261703077,1693233967246,214,172,42
1193,1693233967247,1692261703143,1692261703317,1693233967486,239,174,65
1194,1693233967486,1692261703360,1692261703530,1693233967699,213,170,43
1195,1693233967699,1692261703556,1692261703727,1693233967896,197,171,26
1196,1693233967896,1692261703777,1692261703949,1693233968118,222,172,50
1197,1693233968118,1692261703992,1692261704164,1693233968332,214,172,42
1198,1693233968332,1692261704200,1692261704372,1693233968541,209,172,37
1199,1693233968541,1692261704423,1692261704594,1693233968763,222,171,51
1200,1693233968763,1692261704640,1692261704812,1693233968980,217,172,45
1201,1693233968980,1692261704843,1692261705011,1693233969180,200,168,32
1202,1693233969180,1692261705044,1692261705214,1693233969383,203,170,33
1203,1693233969383,1692261705273,1692261705444,1693233969613,230,171,59
1204,1693233969613,1692261705493,1692261705663,1693233969832,219,170,49
1205,1693233969832,1692261705711,1692261705882,1693233970051,219,171,48
1206,1693233970051,1692261705934,1692261706107,1693233970276,225,173,52
1207,1693233970276,1692261706126,1692261706294,1693233970463,187,168,19
1208,1693233970463,1692261706323,1692261706492,1693233970661,198,169,29
1209,1693233970661,1692261706534,1692261706702,1693233970871,210,168,42
1210,1693233970871,1692261706743,1692261706915,1693233971084,213,172,41
1211,1693233971084,1692261706964,1692261707136,1693233971305,221,172,49
1212,1693233971305,1692261707179,1692261707351,1693233971519,214,172,42
1213,1693233971519,1692261707405,1692261707579,1693233971748,229,174,55
1214,1693233971748,1692261707647,1692261707818,1693233971989,241,171,70
1215,1693233971989,1692261707860,1692261708031,1693233972200,211,171,40
1216,1693233972200,1692261708063,1692261708234,1693233972403,203,171,32
1217,1693233972403,1692261708272,1692261708443,1693233972612,209,171,38
1218,1693233972612,1692261708482,1692261708652,1693233972821,209,170,39
1219,1693233972821,1692261708692,1692261708910,1693233973079,258,218,40
1220,1693233973079,1692261708963,1692261709136,1693233973304,225,173,52
1221,1693233973304,1692261709199,1692261709372,1693233973541,237,173,64
1222,1693233973541,1692261709415,1692261709592,1693233973762,221,177,44
1223,1693233973762,1692261709651,1692261709826,1693233973995,233,175,58
1224,1693233973995,1692261709863,1692261710036,1693233974204,209,173,36
1225,1693233974204,1692261710077,1692261710255,1693233974424,220,178,42
1226,1693233974424,1692261710314,1692261710491,1693233974660,236,177,59
1227,1693233974660,1692261710540,1692261710710,1693233974879,219,170,49
1228,1693233974879,1692261710763,1692261710935,1693233975104,225,172,53
1229,1693233975104,1692261710988,1692261711158,1693233975327,223,170,53
1230,1693233975327,1692261711212,1692261711384,1693233975553,226,172,54
1231,1693233975553,1692261711434,1692261711604,1693233975777,224,170,54
1232,1693233975778,1692261711655,1692261711831,1693233976000,222,176,46
1233,1693233976000,1692261711864,1692261712035,1693233976203,203,171,32
1234,1693233976203,1692261712071,1692261712240,1693233976409,206,169,37
1235,1693233976409,1692261712278,1692261712449,1693233976618,209,171,38
1236,1693233976618,1692261712490,1692261712662,1693233976831,213,172,41
1237,1693233976831,1692261712698,1692261712868,1693233977037,206,170,36
1238,1693233977037,1692261712888,1692261713057,1693233977226,189,169,20
1239,1693233977226,1692261713098,1692261713268,1693233977437,211,170,41
1240,1693233977437,1692261713302,1692261713472,1693233977641,204,170,34
1241,1693233977641,1692261713526,1692261713699,1693233977867,226,173,53
1242,1693233977867,1692261713735,1692261713907,1693233978076,209,172,37
1243,1693233978076,1692261713962,1692261714135,1693233978304,228,173,55
1244,1693233978304,1692261714189,1692261714359,1693233978528,224,170,54
1245,1693233978528,1692261714403,1692261714574,1693233978746,218,171,47
1246,1693233978746,1692261714618,1692261714790,1693233978959,213,172,41
1247,1693233978959,1692261714824,1692261714993,1693233979162,203,169,34
1248,1693233979162,1692261715034,1692261715204,1693233979373,211,170,41
1249,1693233979373,1692261715263,1692261715434,1693233979602,229,171,58
1250,1693233979602,1692261715490,1692261715664,1693233979833,231,174,57
1251,1693233979833,1692261715693,1692261715864,1693233980101,268,171,97
1252,1693233980101,1692261715965,1692261716136,1693233980305,204,171,33
1253,1693233980305,1692261716166,1692261716336,1693233980506,201,170,31
1254,1693233980506,1692261716395,1692261716568,1693233980736,230,173,57
1255,1693233980737,1692261716612,1692261716784,1693233980953,216,172,44
1256,1693233980953,1692261716844,1692261717017,1693233981186,233,173,60
1257,1693233981186,1692261717076,1692261717252,1693233981421,235,176,59
1258,1693233981421,1692261717319,1692261717492,1693233981661,240,173,67
1259,1693233981661,1692261717530,1692261717701,1693233981870,209,171,38
1260,1693233981870,1692261717764,1692261717940,1693233982109,239,176,63
1261,1693233982109,1692261717987,1692261718161,1693233982334,225,174,51
1262,1693233982334,1692261718204,1692261718377,1693233982546,212,173,39
1263,1693233982546,1692261718415,1692261718587,1693233982756,210,172,38
1264,1693233982756,1692261718634,1692261718806,1693233982974,218,172,46
1265,1693233982974,1692261718866,1692261719038,1693233983207,233,172,61
1266,1693233983207,1692261719097,1692261719268,1693233983437,230,171,59
1267,1693233983437,1692261719299,1692261719467,1693233983637,200,168,32
1268,1693233983637,1692261719516,1692261719686,1693233983855,218,170,48
1269,1693233983855,1692261719735,1692261719906,1693233984074,219,171,48
1270,1693233984074,1692261719971,1692261720146,1693233984315,241,175,66
1271,1693233984315,1692261720198,1692261720370,1693233984539,224,172,52
1272,1693233984539,1692261720406,1692261720576,1693233984754,215,170,45
1273,1693233984754,1692261720668,1692261720842,1693233985011,257,174,83
1274,1693233985011,1692261720880,1692261721050,1693233985219,208,170,38
1275,1693233985219,1692261721085,1692261721255,1693233985425,206,170,36
1276,1693233985425,1692261721286,1692261721456,1693233985625,200,170,30
1277,1693233985625,1692261721507,1692261721677,1693233985846,221,170,51
1278,1693233985846,1692261721724,1692261721897,1693233986065,219,173,46
1279,1693233986065,1692261721933,1692261722102,1693233986271,206,169,37
1280,1693233986271,1692261722124,1692261722294,1693233986463,192,170,22
1281,1693233986463,1692261722348,1692261722520,1693233986689,226,172,54
1282,1693233986689,1692261722565,1692261722736,1693233986905,216,171,45
1283,1693233986905,1692261722790,1692261722967,1693233987161,256,177,79
1284,1693233987161,1692261723039,1692261723213,1693233987382,221,174,47
1285,1693233987382,1692261723249,1692261723421,1693233987591,209,172,37
1286,1693233987591,1692261723473,1692261723647,1693233987816,225,174,51
1287,1693233987816,1692261723679,1692261723852,1693233988021,205,173,32
1288,1693233988021,1692261723913,1692261724092,1693233988261,240,179,61
1289,1693233988261,1692261724136,1692261724309,1693233988478,217,173,44
1290,1693233988478,1692261724356,1692261724528,1693233988697,219,172,47
1291,1693233988697,1692261724582,1692261724753,1693233988922,225,171,54
1292,1693233988922,1692261724800,1692261724978,1693233989147,225,178,47
1293,1693233989147,1692261725049,1692261725225,1693233989397,250,176,74
1294,1693233989397,1692261725282,1692261725452,1693233989620,223,170,53
1295,1693233989620,1692261725502,1692261725673,1693233989842,222,171,51
1296,1693233989842,1692261725734,1692261725906,1693233990074,232,172,60
1297,1693233990075,1692261725924,1692261726091,1693233990260,185,167,18
1298,1693233990260,1692261726124,1692261726297,1693233990466,206,173,33
1299,1693233990466,1692261726341,1692261726513,1693233990682,216,172,44
1300,1693233990682,1692261726560,1692261726730,1693233990899,217,170,47
1301,1693233990899,1692261726799,1692261726971,1693233991140,241,172,69
1302,1693233991140,1692261727043,1692261727216,1693233991384,244,173,71
1303,1693233991384,1692261727293,1692261727466,1693233991634,250,173,77
1304,1693233991634,1692261727527,1692261727698,1693233991869,235,171,64
1305,1693233991869,1692261727758,1692261727929,1693233992101,232,171,61
1306,1693233992101,1692261728010,1692261728182,1693233992351,250,172,78
1307,1693233992352,1692261728232,1692261728402,1693233992571,219,170,49
1308,1693233992571,1692261728450,1692261728622,1693233992791,220,172,48
1309,1693233992791,1692261728726,1692261728899,1693233993068,277,173,104
1310,1693233993068,1692261728970,1692261729142,1693233993313,245,172,73
1311,1693233993313,1692261729207,1692261729378,1693233993546,233,171,62
1312,1693233993546,1692261729431,1692261729602,1693233993771,225,171,54
1313,1693233993771,1692261729656,1692261729828,1693233993997,226,172,54
1314,1693233993997,1692261729926,1692261730098,1693233994268,271,172,99
1315,1693233994268,1692261730193,1692261730366,1693233994535,267,173,94
1316,1693233994542,1692261730473,1692261730644,1693233994815,273,171,102
1317,1693233994815,1692261730704,1692261730875,1693233995048,233,171,62
1318,1693233995048,1692261730944,1692261731113,1693233995282,234,169,65
1319,1693233995282,1692261731192,1692261731364,1693233995534,252,172,80
1320,1693233995534,1692261731404,1692261731573,1693233995746,212,169,43
1321,1693233995746,1692261731644,1692261731816,1693233995985,239,172,67
1322,1693233995985,1692261731857,1692261732030,1693233996201,216,173,43
1323,1693233996202,1692261732070,1692261732242,1693233996418,216,172,44
1324,1693233996418,1692261732324,1692261732496,1693233996669,251,172,79
1325,1693233996669,1692261732563,1692261732735,1693233996903,234,172,62
1326,1693233996903,1692261732812,1692261732982,1693233997150,247,170,77
1327,1693233997150,1692261733039,1692261733210,1693233997385,235,171,64
1328,1693233997385,1692261733290,1692261733462,1693233997634,249,172,77
1329,1693233997634,1692261733504,1692261733677,1693233997847,213,173,40
1330,1693233997847,1692261733725,1692261733895,1693233998067,220,170,50
1331,1693233998067,1692261733961,1692261734132,1693233998304,237,171,66
1332,1693233998304,1692261734187,1692261734361,1693233998530,226,174,52
1333,1693233998530,1692261734416,1692261734588,1693233998757,227,172,55
1334,1693233998757,1692261734623,1692261734793,1693233998963,206,170,36
1335,1693233998963,1692261734858,1692261735030,1693233999199,236,172,64
1336,1693233999199,1692261735077,1692261735248,1693233999419,220,171,49
1337,1693233999419,1692261735325,1692261735497,1693233999678,259,172,87
1338,1693233999679,1692261735584,1692261735754,1693233999922,243,170,73
1339,1693233999923,1692261735804,1692261735977,1693234000146,223,173,50
1340,1693234000146,1692261736005,1692261736174,1693234000342,196,169,27
1341,1693234000343,1692261736220,1692261736392,1693234000561,218,172,46
1342,1693234000561,1692261736469,1692261736642,1693234000812,251,173,78
1343,1693234000812,1692261736678,1692261736846,1693234001014,202,168,34
1344,1693234001014,1692261736910,1692261737083,1693234001252,238,173,65
1345,1693234001252,1692261737142,1692261737316,1693234001484,232,174,58
1346,1693234001484,1692261737423,1692261737594,1693234001767,283,171,112
1347,1693234001767,1692261737657,1692261737829,1693234002001,234,172,62
1348,1693234002001,1692261737892,1692261738064,1693234002234,233,172,61
1349,1693234002234,1692261738139,1692261738313,1693234002486,252,174,78
1350,1693234002486,1692261738370,1692261738542,1693234002713,227,172,55
1351,1693234002713,1692261738623,1692261738797,1693234002967,254,174,80
1352,1693234002967,1692261738836,1692261739007,1693234003176,209,171,38
1353,1693234003176,1692261739083,1692261739255,1693234003424,248,172,76
1354,1693234003424,1692261739298,1692261739468,1693234003636,212,170,42
1355,1693234003636,1692261739519,1692261739693,1693234003862,226,174,52
1356,1693234003862,1692261739755,1692261739927,1693234004097,235,172,63
1357,1693234004097,1692261740023,1692261740196,1693234004365,268,173,95
1358,1693234004365,1692261740286,1692261740457,1693234004625,260,171,89
1359,1693234004625,1692261740578,1692261740751,1693234004920,295,173,122
1360,1693234004920,1692261740812,1692261740984,1693234005153,233,172,61
1361,1693234005153,1692261741116,1692261741289,1693234005462,309,173,136
1362,1693234005462,1692261741386,1692261741559,1693234005728,266,173,93
1363,1693234005728,1692261741608,1692261741780,1693234005951,223,172,51
1364,1693234005951,1692261741839,1692261742011,1693234006184,233,172,61
1365,1693234006184,1692261742068,1692261742238,1693234006407,223,170,53
1366,1693234006407,1692261742356,1692261742527,1693234006696,289,171,118
1367,1693234006696,1692261742610,1692261742782,1693234006952,256,172,84
1368,1693234006952,1692261742854,1692261743024,1693234007193,241,170,71
1369,1693234007193,1692261743110,1692261743283,1693234007452,259,173,86
1370,1693234007452,1692261743375,1692261743547,1693234007717,265,172,93
1371,1693234007717,1692261743621,1692261743793,1693234007967,250,172,78
1372,1693234007967,1692261743895,1692261744067,1693234008236,269,172,97
1373,1693234008236,1692261744126,1692261744297,1693234008466,230,171,59
1374,1693234008466,1692261744327,1692261744496,1693234008664,198,169,29
1375,1693234008664,1692261744543,1692261744717,1693234008886,222,174,48
1376,1693234008886,1692261744777,1692261744948,1693234009118,232,171,61
1377,1693234009118,1692261745006,1692261745177,1693234009347,229,171,58
1378,1693234009347,1692261745265,1692261745438,1693234009610,263,173,90
1379,1693234009610,1692261745493,1692261745666,1693234009835,225,173,52
1380,1693234009835,1692261745724,1692261745895,1693234010104,269,171,98
1381,1693234010104,1692261746060,1692261746233,1693234010402,298,173,125
1382,1693234010403,1692261746294,1692261746469,1693234010638,235,175,60
1383,1693234010638,1692261746559,1692261746730,1693234010898,260,171,89
1384,1693234010898,1692261746762,1692261746931,1693234011104,206,169,37
1385,1693234011104,1692261747009,1692261747181,1693234011349,245,172,73
1386,1693234011349,1692261747268,1692261747440,1693234011608,259,172,87
1387,1693234011608,1692261747505,1692261747678,1693234011854,246,173,73
1388,1693234011854,1692261747738,1692261747909,1693234012077,223,171,52
1389,1693234012077,1692261747959,1692261748130,1693234012301,224,171,53
1390,1693234012301,1692261748212,1692261748384,1693234012554,253,172,81
1391,1693234012554,1692261748431,1692261748603,1693234012772,218,172,46
1392,1693234012772,1692261748679,1692261748854,1693234013022,250,175,75
1393,1693234013022,1692261748891,1692261749061,1693234013229,207,170,37
1394,1693234013229,1692261749141,1692261749313,1693234013482,253,172,81
1395,1693234013482,1692261749343,1692261749513,1693234013681,199,170,29
1396,1693234013681,1692261749556,1692261749726,1693234013895,214,170,44
1397,1693234013895,1692261749828,1692261750000,1693234014168,273,172,101
1398,1693234014168,1692261750077,1692261750249,1693234014418,250,172,78
1399,1693234014418,1692261750306,1692261750478,1693234014657,239,172,67
1400,1693234014657,1692261750527,1692261750698,1693234014868,211,171,40
1401,1693234014868,1692261750771,1692261750943,1693234015114,246,172,74
1402,1693234015114,1692261751022,1692261751196,1693234015365,251,174,77
1403,1693234015365,1692261751296,1692261751470,1693234015638,273,174,99
1404,1693234015638,1692261751521,1692261751694,1693234015869,231,173,58
1405,1693234015869,1692261751783,1692261751956,1693234016124,255,173,82
1406,1693234016124,1692261752009,1692261752182,1693234016353,229,173,56
1407,1693234016353,1692261752240,1692261752412,1693234016581,228,172,56
1408,1693234016581,1692261752476,1692261752648,1693234016817,236,172,64
1409,1693234016817,1692261752702,1692261752876,1693234017045,228,174,54
1410,1693234017045,1692261752925,1692261753098,1693234017267,222,173,49
1411,1693234017267,1692261753144,1692261753316,1693234017484,217,172,45
1412,1693234017484,1692261753346,1692261753516,1693234017685,201,170,31
1413,1693234017685,1692261753542,1692261753710,1693234017879,194,168,26
1414,1693234017879,1692261753748,1692261753917,1693234018086,207,169,38
1415,1693234018086,1692261753962,1692261754134,1693234018302,216,172,44
1416,1693234018302,1692261754177,1692261754349,1693234018517,215,172,43
1417,1693234018517,1692261754399,1692261754572,1693234018740,223,173,50
1418,1693234018740,1692261754627,1692261754800,1693234018968,228,173,55
1419,1693234018968,1692261754834,1692261755004,1693234019172,204,170,34
1420,1693234019172,1692261755066,1692261755239,1693234019408,236,173,63
1421,1693234019408,1692261755281,1692261755454,1693234019623,215,173,42
1422,1693234019623,1692261755505,1692261755679,1693234019848,225,174,51
1423,1693234019848,1692261755732,1692261755905,1693234020073,225,173,52
1424,1693234020073,1692261755960,1692261756132,1693234020300,227,172,55
1425,1693234020300,1692261756175,1692261756347,1693234020516,216,172,44
1426,1693234020516,1692261756375,1692261756544,1693234020712,196,169,27
1427,1693234020712,1692261756583,1692261756754,1693234020923,211,171,40
1428,1693234020923,1692261756810,1692261756981,1693234021149,226,171,55
1429,1693234021149,1692261757017,1692261757188,1693234021356,207,171,36
1430,1693234021356,1692261757237,1692261757411,1693234021580,224,174,50
1431,1693234021580,1692261757443,1692261757614,1693234021783,203,171,32
1432,1693234021783,1692261757680,1692261757853,1693234022022,239,173,66
1433,1693234022022,1692261757930,1692261758102,1693234022271,249,172,77
1434,1693234022271,1692261758152,1692261758324,1693234022492,221,172,49
1435,1693234022492,1692261758368,1692261758540,1693234022709,217,172,45
1436,1693234022709,1692261758574,1692261758744,1693234022912,203,170,33
1437,1693234022912,1692261758813,1692261758988,1693234023157,245,175,70
1438,1693234023157,1692261759048,1692261759218,1693234023392,235,170,65
1439,1693234023392,1692261759278,1692261759451,1693234023620,228,173,55
1440,1693234023620,1692261759495,1692261759666,1693234023835,215,171,44
1441,1693234023835,1692261759695,1692261759866,1693234024034,199,171,28
1442,1693234024035,1692261759891,1692261760061,1693234024230,195,170,25
1443,1693234024230,1692261760107,1692261760278,1693234024446,216,171,45
1444,1693234024447,1692261760303,1692261760474,1693234024642,195,171,24
1445,1693234024812,1692261760699,1692261761059,1693234025228,416,360,56
1446,1693234025228,1692261761124,1692261761437,1693234025605,377,313,64
1447,1693234025605,1692261761468,1692261761734,1693234025903,298,266,32
1448,1693234025903,1692261761771,1692261762093,1693234026262,359,322,37
1449,1693234026262,1692261762125,1692261762403,1693234026572,310,278,32
1450,1693234026572,1692261762446,1692261762621,1693234026790,218,175,43
1451,1693234026790,1692261762666,1692261762838,1693234027006,216,172,44
1452,1693234027006,1692261762860,1692261763030,1693234027199,193,170,23
1453,1693234027199,1692261763067,1692261763237,1693234027405,206,170,36
1454,1693234027405,1692261763274,1692261763444,1693234027612,207,170,37
1455,1693234027612,1692261763471,1692261763640,1693234027808,196,169,27
1456,1693234027808,1692261763696,1692261763868,1693234028037,229,172,57
1457,1693234028037,1692261763908,1692261764079,1693234028247,210,171,39
1458,1693234028247,1692261764110,1692261764280,1693234028448,201,170,31
1459,1693234028448,1692261764326,1692261764497,1693234028665,217,171,46
1460,1693234028665,1692261764536,1692261764708,1693234028877,212,172,40
1461,1693234028877,1692261764767,1692261764941,1693234029110,233,174,59
1462,1693234029110,1692261764982,1692261765154,1693234029322,212,172,40
1463,1693234029322,1692261765211,1692261765384,1693234029552,230,173,57
1464,1693234029552,1692261765403,1692261765573,1693234029741,189,170,19
1465,1693234029742,1692261765611,1692261765781,1693234029949,207,170,37
1466,1693234029949,1692261765817,1692261765986,1693234030154,205,169,36
1467,1693234030154,1692261766013,1692261766183,1693234030354,200,170,30
1468,1693234030354,1692261766216,1692261766385,1693234030553,199,169,30
1469,1693234030553,1692261766418,1692261766587,1693234030755,202,169,33
1470,1693234030755,1692261766629,1692261766799,1693234030970,215,170,45
1471,1693234030970,1692261766843,1692261767015,1693234031183,213,172,41
1472,1693234031184,1692261767075,1692261767246,1693234031414,230,171,59
1473,1693234031414,1692261767302,1692261767474,1693234031642,228,172,56
1474,1693234031642,1692261767495,1692261767664,1693234031833,191,169,22
1475,1693234031833,1692261767694,1692261767862,1693234032031,198,168,30
1476,1693234032031,1692261767909,1692261768081,1693234032249,218,172,46
1477,1693234032249,1692261768098,1692261768268,1693234032436,187,170,17
1478,1693234032436,1692261768307,1692261768477,1693234032645,209,170,39
1479,1693234032645,1692261768507,1692261768677,1693234032846,201,170,31
1480,1693234032846,1692261768702,1692261768871,1693234033039,193,169,24
1481,1693234033039,1692261768913,1692261769085,1693234033253,214,172,42
1482,1693234033253,1692261769160,1692261769333,1693234033501,248,173,75
1483,1693234033501,1692261769387,1692261769564,1693234033734,233,177,56
1484,1693234033734,1692261769604,1692261769788,1693234033956,222,184,38
1485,1693234033956,1692261769829,1692261770002,1693234034171,215,173,42
1486,1693234034171,1692261770049,1692261770221,1693234034392,221,172,49
1487,1693234034392,1692261770277,1692261770456,1693234034624,232,179,53
1488,1693234034624,1692261770515,1692261770687,1693234034858,234,172,62
1489,1693234034858,1692261770747,1692261770937,1693234035105,247,190,57
1490,1693234035106,1692261770984,1692261771160,1693234035329,223,176,47
1491,1693234035329,1692261771215,1692261771388,1693234035556,227,173,54
1492,1693234035556,1692261771444,1692261771617,1693234035785,229,173,56
1493,1693234035785,1692261771659,1692261771832,1693234036000,215,173,42
1494,1693234036000,1692261771881,1692261772054,1693234036222,222,173,49
1495,1693234036222,1692261772097,1692261772268,1693234036436,214,171,43
1496,1693234036437,1692261772298,1692261772468,1693234036636,199,170,29
1497,1693234036637,1692261772528,1692261772701,1693234036869,232,173,59
1498,1693234036869,1692261772755,1692261772927,1693234037095,226,172,54
1499,1693234037095,1692261772989,1692261773161,1693234037329,234,172,62
1500,1693234037329,1692261773223,1692261773397,1693234037566,237,174,63
1501,1693234037566,1692261773445,1692261773619,1693234037787,221,174,47
1502,1693234037787,1692261773683,1692261773855,1693234038023,236,172,64
1503,1693234038023,1692261773892,1692261774063,1693234038231,208,171,37
1504,1693234038231,1692261774112,1692261774286,1693234038454,223,174,49
1505,1693234038454,1692261774324,1692261774496,1693234038664,210,172,38
1506,1693234038664,1692261774521,1692261774691,1693234038859,195,170,25
1507,1693234038859,1692261774735,1692261774906,1693234039074,215,171,44
1508,1693234039074,1692261774943,1692261775115,1693234039284,210,172,38
1509,1693234039284,1692261775152,1692261775323,1693234039491,207,171,36
1510,1693234039491,1692261775385,1692261775559,1693234039728,237,174,63
1511,1693234039728,1692261775606,1692261775780,1693234039948,220,174,46
1512,1693234039949,1692261775819,1692261775989,1693234040157,208,170,38
1513,1693234040157,1692261776045,1692261776216,1693234040384,227,171,56
1514,1693234040384,1692261776267,1692261776441,1693234040609,225,174,51
1515,1693234040609,1692261776476,1692261776650,1693234040818,209,174,35
1516,1693234040818,1692261776692,1692261776865,1693234041033,215,173,42
1517,1693234041033,1692261776902,1692261777072,1693234041241,208,170,38
1518,1693234041241,1692261777106,1692261777280,1693234041448,207,174,33
1519,1693234041448,1692261777323,1692261777504,1693234041673,225,181,44
1520,1693234041673,1692261777570,1692261777744,1693234041913,240,174,66
1521,1693234041913,1692261777796,1692261777970,1693234042138,225,174,51
1522,1693234042138,1692261777999,1692261778172,1693234042340,202,173,29
1523,1693234042340,1692261778226,1692261778402,1693234042571,231,176,55
1524,1693234042571,1692261778447,1692261778628,1693234042796,225,181,44
1525,1693234042796,1692261778672,1692261778841,1693234043009,213,169,44
1526,1693234043010,1692261778885,1692261779055,1693234043224,214,170,44
1527,1693234043224,1692261779100,1692261779270,1693234043438,214,170,44
1528,1693234043438,1692261779313,1692261779484,1693234043652,214,171,43
1529,1693234043652,1692261779522,1692261779692,1693234043860,208,170,38
1530,1693234043860,1692261779745,1692261779917,1693234044085,225,172,53
1531,1693234044085,1692261779965,1692261780140,1693234044308,223,175,48
1532,1693234044308,1692261780187,1692261780357,1693234044525,217,170,47
1533,1693234044525,1692261780436,1692261780613,1693234044781,256,177,79
1534,1693234044781,1692261780660,1692261780833,1693234045001,220,173,47
1535,1693234045001,1692261780877,1692261781046,1693234045214,213,169,44
1536,1693234045214,1692261781104,1692261781276,1693234045445,231,172,59
1537,1693234045445,1692261781329,1692261781500,1693234045670,225,171,54
1538,1693234045670,1692261781516,1692261781685,1693234045853,183,169,14
1539,1693234045853,1692261781717,1692261781887,1693234046055,202,170,32
1540,1693234046055,1692261781929,1692261782100,1693234046268,213,171,42
1541,1693234046268,1692261782152,1692261782327,1693234046495,227,175,52
1542,1693234046495,1692261782375,1692261782547,1693234046715,220,172,48
1543,1693234046715,1692261782603,1692261782774,1693234046942,227,171,56
1544,1693234046942,1692261782831,1692261783005,1693234047173,231,174,57
1545,1693234047173,1692261783035,1692261783204,1693234047372,199,169,30
1546,1693234047372,1692261783247,1692261783419,1693234047587,215,172,43
1547,1693234047587,1692261783457,1692261783633,1693234047801,214,176,38
1548,1693234047801,1692261783683,1692261783861,1693234048029,228,178,50
1549,1693234048029,1692261783898,1692261784068,1693234048236,207,170,37
1550,1693234048236,1692261784118,1692261784295,1693234048463,227,177,50
1551,1693234048463,1692261784353,1692261784555,1693234048724,261,202,59
1552,1693234048724,1692261784601,1692261784778,1693234048946,222,177,45
1553,1693234048947,1692261784812,1692261784984,1693234049153,206,172,34
1554,1693234049153,1692261785020,1692261785192,1693234049360,207,172,35
1555,1693234049360,1692261785225,1692261785395,1693234049568,208,170,38
1556,1693234049569,1692261785430,1692261785608,1693234049777,208,178,30
1557,1693234049777,1692261785637,1692261785819,1693234049987,210,182,28
1558,1693234049987,1692261785869,1692261786042,1693234050210,223,173,50
1559,1693234050210,1692261786098,1692261786270,1693234050437,227,172,55
1560,1693234050438,1692261786307,1692261786478,1693234050646,208,171,37
1561,1693234050646,1692261786521,1692261786696,1693234050864,218,175,43
1562,1693234050864,1692261786740,1692261786911,1693234051079,215,171,44
1563,1693234051079,1692261786960,1692261787132,1693234051300,221,172,49
1564,1693234051300,1692261787176,1692261787350,1693234051518,218,174,44
1565,1693234051518,1692261787407,1692261787577,1693234051746,228,170,58
1566,1693234051746,1692261787632,1692261787804,1693234051972,226,172,54
1567,1693234051972,1692261787860,1692261788031,1693234052199,227,171,56
1568,1693234052199,1692261788093,1692261788265,1693234052433,234,172,62
1569,1693234052433,1692261788310,1692261788483,1693234052651,218,173,45
1570,1693234052651,1692261788522,1692261788695,1693234052863,212,173,39
1571,1693234052863,1692261788739,1692261788911,1693234053079,216,172,44
1572,1693234053079,1692261788977,1692261789149,1693234053317,238,172,66
1573,1693234053317,1692261789206,1692261789380,1693234053548,231,174,57
1574,1693234053548,1692261789419,1692261789591,1693234053759,211,172,39
1575,1693234053759,1692261789625,1692261789794,1693234053962,203,169,34
1576,1693234053963,1692261789827,1692261789997,1693234054165,202,170,32
1577,1693234054165,1692261790067,1692261790238,1693234054406,241,171,70
1578,1693234054406,1692261790273,1692261790444,1693234054612,206,171,35
1579,1693234054612,1692261790482,1692261790651,1693234054819,207,169,38
1580,1693234054830,1692261790698,1692261790869,1693234055037,207,171,36
1581,1693234055037,1692261790912,1692261791082,1693234055250,213,170,43
1582,1693234055250,1692261791116,1692261791285,1693234055453,203,169,34
1583,1693234055453,1692261791354,1692261791526,1693234055696,243,172,71
1584,1693234055696,1692261791591,1692261791761,1693234055929,233,170,63
1585,1693234055929,1692261791815,1692261791986,1693234056159,230,171,59
1586,1693234056159,1692261792020,1692261792189,1693234056357,198,169,29
1587,1693234056357,1692261792220,1692261792389,1693234056557,200,169,31
1588,1693234056558,1692261792421,1692261792590,1693234056758,200,169,31
1589,1693234056758,1692261792633,1692261792809,1693234056977,219,176,43
1590,1693234056977,1692261792863,1692261793036,1693234057204,227,173,54
1591,1693234057204,1692261793087,1692261793258,1693234057426,222,171,51
1592,1693234057426,1692261793301,1692261793472,1693234057640,214,171,43
1593,1693234057640,1692261793524,1692261793697,1693234057865,225,173,52
1594,1693234057865,1692261793739,1692261793910,1693234058078,213,171,42
1595,1693234058078,1692261793964,1692261794136,1693234058304,226,172,54
1596,1693234058304,1692261794175,1692261794345,1693234058514,210,170,40
1597,1693234058514,1692261794401,1692261794574,1693234058742,228,173,55
1598,1693234058742,1692261794623,1692261794794,1693234058962,220,171,49
1599,1693234058962,1692261794836,1692261795007,1693234059175,213,171,42
1600,1693234059175,1692261795037,1692261795207,1693234059375,200,170,30
1601,1693234059375,1692261795255,1692261795427,1693234059595,220,172,48
1602,1693234059595,1692261795477,1692261795648,1693234059816,221,171,50
1603,1693234059816,1692261795689,1692261795859,1693234060028,212,170,42
1604,1693234060028,1692261795922,1692261796094,1693234060262,234,172,62
1605,1693234060262,1692261796141,1692261796314,1693234060482,220,173,47
1606,1693234060482,1692261796354,1692261796525,1693234060693,211,171,40
1607,1693234060693,1692261796582,1692261796757,1693234060925,232,175,57
1608,1693234060925,1692261796810,1692261796984,1693234061151,226,174,52
1609,1693234061151,1692261797030,1692261797202,1693234061370,219,172,47
1610,1693234061370,1692261797246,1692261797419,1693234061587,217,173,44
1611,1693234061587,1692261797458,1692261797627,1693234061795,208,169,39
1612,1693234061795,1692261797666,1692261797836,1693234062003,208,170,38
1613,1693234062003,1692261797862,1692261798032,1693234062200,197,170,27
1614,1693234062200,1692261798086,1692261798256,1693234062424,224,170,54
1615,1693234062424,1692261798318,1692261798489,1693234062657,233,171,62
1616,1693234062657,1692261798522,1692261798692,1693234062860,203,170,33
1617,1693234062860,1692261798757,1692261798932,1693234063100,240,175,65
1618,1693234063100,1692261798987,1692261799159,1693234063328,228,172,56
1619,1693234063328,1692261799204,1692261799376,1693234063544,216,172,44
1620,1693234063544,1692261799436,1692261799608,1693234063777,233,172,61
1621,1693234063777,1692261799636,1692261799805,1693234063973,196,169,27
1622,1693234063973,1692261799861,1692261800032,1693234064201,228,171,57
1623,1693234064201,1692261800057,1692261800227,1693234064395,194,170,24
1624,1693234064395,1692261800264,1692261800434,1693234064602,207,170,37
1625,1693234064602,1692261800480,1692261800650,1693234064818,216,170,46
1626,1693234064818,1692261800700,1692261800872,1693234065041,223,172,51
1627,1693234065041,1692261800930,1692261801102,1693234065272,231,172,59
1628,1693234065272,1692261801139,1692261801309,1693234065478,206,170,36
1629,1693234065478,1692261801340,1692261801509,1693234065676,198,169,29
1630,1693234065676,1692261801578,1692261801751,1693234065919,243,173,70
1631,1693234065919,1692261801800,1692261801969,1693234066137,218,169,49
1632,1693234066137,1692261802020,1692261802193,1693234066361,224,173,51
1633,1693234066361,1692261802240,1692261802412,1693234066580,219,172,47
1634,1693234066580,1692261802465,1692261802636,1693234066806,226,171,55
1635,1693234066806,1692261802685,1692261802856,1693234067025,219,171,48
1636,1693234067025,1692261802887,1692261803055,1693234067228,203,168,35
1637,1693234067228,1692261803106,1692261803278,1693234067446,218,172,46
1638,1693234067446,1692261803335,1692261803507,1693234067676,230,172,58
1639,1693234067676,1692261803557,1692261803728,1693234067895,219,171,48
1640,1693234067896,1692261803767,1692261803938,1693234068106,210,171,39
1641,1693234068106,1692261803968,1692261804138,1693234068306,200,170,30
1642,1693234068306,1692261804187,1692261804359,1693234068527,221,172,49
1643,1693234068527,1692261804400,1692261804572,1693234068740,213,172,41
1644,1693234068740,1692261804615,1692261804787,1693234068959,219,172,47
1645,1693234068959,1692261804839,1692261805011,1693234069179,220,172,48
1646,1693234069179,1692261805057,1692261805230,1693234069397,218,173,45
1647,1693234069397,1692261805272,1692261805445,1693234069613,216,173,43
1648,1693234069613,1692261805481,1692261805651,1693234069818,205,170,35
1649,1693234069819,1692261805690,1692261805862,1693234070109,290,172,118
1650,1693234070109,1692261805982,1692261806155,1693234070322,213,173,40
1651,1693234070322,1692261806200,1692261806370,1693234070538,216,170,46
1652,1693234070538,1692261806443,1692261806615,1693234070783,245,172,73
1653,1693234070783,1692261806659,1692261806830,1693234070998,215,171,44
1654,1693234070998,1692261806865,1692261807036,1693234071204,206,171,35
1655,1693234071204,1692261807075,1692261807246,1693234071416,212,171,41
1656,1693234071416,1692261807282,1692261807449,1693234071622,206,167,39
1657,1693234071622,1692261807492,1692261807666,1693234071834,212,174,38
1658,1693234071834,1692261807698,1692261807867,1693234072034,200,169,31
1659,1693234072034,1692261807908,1692261808081,1693234072248,214,173,41
1660,1693234072248,1692261808119,1692261808290,1693234072457,209,171,38
1661,1693234072457,1692261808331,1692261808501,1693234072669,212,170,42
1662,1693234072669,1692261808543,1692261808714,1693234072882,213,171,42
1663,1693234072882,1692261808745,1692261808914,1693234073082,200,169,31
1664,1693234073082,1692261808955,1692261809125,1693234073293,211,170,41
1665,1693234073293,1692261809155,1692261809324,1693234073492,199,169,30
1666,1693234073492,1692261809372,1692261809544,1693234073713,221,172,49
1667,1693234073714,1692261809592,1692261809766,1693234073935,221,174,47
1668,1693234073935,1692261809821,1692261809994,1693234074162,227,173,54
1669,1693234074162,1692261810050,1692261810222,1693234074390,228,172,56
1670,1693234074390,1692261810275,1692261810449,1693234074617,227,174,53
1671,1693234074617,1692261810505,1692261810676,1693234074844,227,171,56
1672,1693234074844,1692261810711,1692261810884,1693234075052,208,173,35
1673,1693234075052,1692261810947,1692261811120,1693234075334,282,173,109
1674,1693234075334,1692261811212,1692261811384,1693234075613,279,172,107
1675,1693234075613,1692261811495,1692261811667,1693234075905,292,172,120
1676,1693234075905,1692261811786,1692261811957,1693234076126,221,171,50
1677,1693234076126,1692261812005,1692261812177,1693234076345,219,172,47
1678,1693234076345,1692261812208,1692261812376,1693234076544,199,168,31
1679,1693234076544,1692261812410,1692261812580,1693234076747,203,170,33
1680,1693234076747,1692261812629,1692261812804,1693234076972,225,175,50
1681,1693234076972,1692261812851,1692261813021,1693234077189,217,170,47
1682,1693234077189,1692261813067,1692261813239,1693234077406,217,172,45
1683,1693234077407,1692261813286,1692261813458,1693234077626,219,172,47
1684,1693234077626,1692261813491,1692261813658,1693234077827,201,167,34
1685,1693234077827,1692261813717,1692261813890,1693234078057,230,173,57
1686,1693234078058,1692261813940,1692261814112,1693234078280,222,172,50
1687,1693234078280,1692261814154,1692261814328,1693234078496,216,174,42
1688,1693234078496,1692261814378,1692261814552,1693234078719,223,174,49
1689,1693234078719,1692261814584,1692261814756,1693234078924,205,172,33
1690,1693234078924,1692261814785,1692261814956,1693234079124,200,171,29
1691,1693234079124,1692261814990,1692261815158,1693234079327,203,168,35
1692,1693234079327,1692261815209,1692261815381,1693234079549,222,172,50
1693,1693234079549,1692261815431,1692261815603,1693234079771,222,172,50
1694,1693234079771,1692261815644,1692261815814,1693234079982,211,170,41
1695,1693234079982,1692261815849,1692261816018,1693234080186,204,169,35
1696,1693234080186,1692261816059,1692261816229,1693234080397,211,170,41
1697,1693234080397,1692261816275,1692261816448,1693234080615,218,173,45
1698,1693234080615,1692261816500,1692261816671,1693234080839,224,171,53
1699,1693234080839,1692261816721,1692261816894,1693234081061,222,173,49
1700,1693234081061,1692261816940,1692261817113,1693234081281,220,173,47
1701,1693234081281,1692261817161,1692261817334,1693234081501,220,173,47
1702,1693234081501,1692261817377,1692261817550,1693234081718,217,173,44
1703,1693234081718,1692261817596,1692261817770,1693234081938,220,174,46
1704,1693234081938,1692261817819,1692261817990,1693234082158,220,171,49
1705,1693234082159,1692261818056,1692261818229,1693234082397,238,173,65
1706,1693234082397,1692261818281,1692261818452,1693234082619,222,171,51
1707,1693234082619,1692261818501,1692261818673,1693234082841,222,172,50
1708,1693234082841,1692261818727,1692261818898,1693234083066,225,171,54
1709,1693234083066,1692261818948,1692261819119,1693234083287,221,171,50
1710,1693234083287,1692261819181,1692261819355,1693234083522,235,174,61
1711,1693234083523,1692261819412,1692261819585,1693234083752,229,173,56
1712,1693234083752,1692261819616,1692261819784,1693234083952,200,168,32
1713,1693234083952,1692261819833,1692261820007,1693234084174,222,174,48
1714,1693234084174,1692261820040,1692261820209,1693234084377,203,169,34
1715,1693234084377,1692261820238,1692261820408,1693234084576,199,170,29
1716,1693234084576,1692261820446,1692261820614,1693234084782,206,168,38
1717,1693234084782,1692261820659,1692261820833,1693234085001,219,174,45
1718,1693234085174,1692261821071,1692261821417,1693234085585,411,346,65
1719,1693234085585,1692261821473,1692261821730,1693234085930,345,257,88
1720,1693234085930,1692261821801,1692261822133,1693234086367,437,332,105
1721,1693234086367,1692261822240,1692261822419,1693234086587,220,179,41
1722,1693234086587,1692261822451,1692261822750,1693234086918,331,299,32
1723,1693234086918,1692261822795,1692261822968,1693234087136,218,173,45
1724,1693234087136,1692261823006,1692261823175,1693234087343,207,169,38
1725,1693234087343,1692261823215,1692261823386,1693234087554,211,171,40
1726,1693234087554,1692261823452,1692261823624,1693234087799,245,172,73
1727,1693234087800,1692261823687,1692261823860,1693234088028,228,173,55
1728,1693234088028,1692261823899,1692261824070,1693234088238,210,171,39
1729,1693234088238,1692261824117,1692261824289,1693234088457,219,172,47
1730,1693234088457,1692261824336,1692261824506,1693234088674,217,170,47
1731,1693234088674,1692261824552,1692261824724,1693234088891,217,172,45
1732,1693234088891,1692261824751,1692261824920,1693234089088,197,169,28
1733,1693234089088,1692261824979,1692261825150,1693234089317,229,171,58
1734,1693234089317,1692261825208,1692261825380,1693234089548,231,172,59
1735,1693234089548,1692261825459,1692261825632,1693234089800,252,173,79
1736,1693234089800,1692261825670,1692261825841,1693234090009,209,171,38
1737,1693234090009,1692261825902,1692261826076,1693234090243,234,174,60
1738,1693234090244,1692261826114,1692261826285,1693234090453,209,171,38
1739,1693234090453,1692261826322,1692261826493,1693234090661,208,171,37
1740,1693234090661,1692261826521,1692261826690,1693234090858,197,169,28
1741,1693234090858,1692261826736,1692261826909,1693234091077,219,173,46
1742,1693234091077,1692261826973,1692261827146,1693234091313,236,173,63
1743,1693234091313,1692261827191,1692261827362,1693234091530,217,171,46
1744,1693234091530,1692261827400,1692261827573,1693234091740,210,173,37
1745,1693234091741,1692261827618,1692261827791,1693234091958,217,173,44
1746,1693234091958,1692261827842,1692261828016,1693234092184,226,174,52
1747,1693234092184,1692261828057,1692261828229,1693234092402,218,172,46
1748,1693234092403,1692261828277,1692261828448,1693234092616,213,171,42
1749,1693234092616,1692261828492,1692261828666,1693234092833,217,174,43
1750,1693234092833,1692261828718,1692261828890,1693234093061,228,172,56
1751,1693234093061,1692261828945,1692261829118,1693234093285,224,173,51
1752,1693234093285,1692261829161,1692261829333,1693234093501,216,172,44
1753,1693234093501,1692261829361,1692261829534,1693234093703,202,173,29
1754,1693234093703,1692261829601,1692261829777,1693234093945,242,176,66
1755,1693234093945,1692261829800,1692261829970,1693234094137,192,170,22
1756,1693234094137,1692261830035,1692261830211,1693234094392,255,176,79
1757,1693234094392,1692261830275,1692261830454,1693234094622,230,179,51
1758,1693234094622,1692261830503,1692261830676,1693234094844,222,173,49
1759,1693234094844,1692261830729,1692261830909,1693234095077,233,180,53
1760,1693234095077,1692261830953,1692261831133,1693234095300,223,180,43
1761,1693234095300,1692261831180,1692261831354,1693234095521,221,174,47
1762,1693234095521,1692261831402,1692261831575,1693234095742,221,173,48
1763,1693234095742,1692261831618,1692261831788,1693234095956,214,170,44
1764,1693234095956,1692261831853,1692261832024,1693234096198,242,171,71
1765,1693234096198,1692261832094,1692261832265,1693234096432,234,171,63
1766,1693234096432,1692261832313,1692261832484,1693234096652,220,171,49
1767,1693234096652,1692261832523,1692261832694,1693234096861,209,171,38
1768,1693234096861,1692261832726,1692261832895,1693234097063,202,169,33
1769,1693234097063,1692261832949,1692261833124,1693234097292,229,175,54
1770,1693234097292,1692261833186,1692261833357,1693234097527,235,171,64
1771,1693234097527,1692261833403,1692261833575,1693234097742,215,172,43
1772,1693234097743,1692261833619,1692261833791,1693234097958,215,172,43
1773,1693234097958,1692261833842,1692261834014,1693234098182,224,172,52
1774,1693234098182,1692261834043,1692261834212,1693234098379,197,169,28
1775,1693234098379,1692261834261,1692261834433,1693234098601,222,172,50
1776,1693234098601,1692261834486,1692261834660,1693234098829,228,174,54
1777,1693234098829,1692261834707,1692261834878,1693234099045,216,171,45
1778,1693234099045,1692261834941,1692261835115,1693234099282,237,174,63
1779,1693234099282,1692261835150,1692261835322,1693234099490,208,172,36
1780,1693234099490,1692261835363,1692261835533,1693234099701,211,170,41
1781,1693234099701,1692261835588,1692261835760,1693234099977,276,172,104
1782,1693234099977,1692261835840,1692261836012,1693234100179,202,172,30
1783,1693234100179,1692261836040,1692261836209,1693234100377,198,169,29
1784,1693234100377,1692261836251,1692261836421,1693234100589,212,170,42
1785,1693234100589,1692261836462,1692261836632,1693234100805,216,170,46
1786,1693234100805,1692261836680,1692261836852,1693234101020,215,172,43
1787,1693234101020,1692261836896,1692261837070,1693234101237,217,174,43
1788,1693234101237,1692261837096,1692261837270,1693234101437,200,174,26
1789,1693234101438,1692261837314,1692261837491,1693234101659,221,177,44
1790,1693234101659,1692261837527,1692261837700,1693234101868,209,173,36
1791,1693234101868,1692261837759,1692261837937,1693234102105,237,178,59
1792,1693234102105,1692261838008,1692261838185,1693234102353,248,177,71
1793,1693234102353,1692261838220,1692261838395,1693234102563,210,175,35
1794,1693234102563,1692261838442,1692261838617,1693234102785,222,175,47
1795,1693234102785,1692261838663,1692261838835,1693234103003,218,172,46
1796,1693234103003,1692261838871,1692261839041,1693234103209,206,170,36
1797,1693234103209,1692261839086,1692261839258,1693234103425,216,172,44
1798,1693234103425,1692261839289,1692261839459,1693234103627,202,170,32
1799,1693234103627,1692261839519,1692261839692,1693234103860,233,173,60
1800,1693234103860,1692261839735,1692261839906,1693234104073,213,171,42
1801,1693234104074,1692261839948,1692261840121,1693234104290,216,173,43
1802,1693234104290,1692261840171,1692261840343,1693234104510,220,172,48
1803,1693234104510,1692261840395,1692261840567,1693234104741,231,172,59
1804,1693234104741,1692261840628,1692261840799,1693234104966,225,171,54
1805,1693234104966,1692261840832,1692261841002,1693234105169,203,170,33
1806,1693234105169,1692261841071,1692261841243,1693234105413,244,172,72
1807,1693234105413,1692261841277,1692261841446,1693234105617,204,169,35
1808,1693234105617,1692261841497,1692261841669,1693234105837,220,172,48
1809,1693234105837,1692261841717,1692261841890,1693234106059,222,173,49
1810,1693234106059,1692261841925,1692261842094,1693234106263,204,169,35
1811,1693234106263,1692261842119,1692261842289,1693234106456,193,170,23
1812,1693234106457,1692261842332,1692261842502,1693234106669,212,170,42
1813,1693234106669,1692261842583,1692261842754,1693234106922,253,171,82
1814,1693234106922,1692261842817,1692261842989,1693234107159,237,172,65
1815,1693234107159,1692261843052,1692261843225,1693234107392,233,173,60
1816,1693234107392,1692261843264,1692261843438,1693234107605,213,174,39
1817,1693234107605,1692261843513,1692261843686,1693234107853,248,173,75
1818,1693234107853,1692261843738,1692261843910,1693234108077,224,172,52
1819,1693234108077,1692261843971,1692261844153,1693234108321,244,182,62
1820,1693234108321,1692261844200,1692261844373,1693234108540,219,173,46
1821,1693234108540,1692261844402,1692261844575,1693234108742,202,173,29
1822,1693234108742,1692261844616,1692261844804,1693234108972,230,188,42
1823,1693234108972,1692261844852,1692261845026,1693234109194,222,174,48
1824,1693234109194,1692261845076,1692261845251,1693234109419,225,175,50
1825,1693234109419,1692261845304,1692261845481,1693234109649,230,177,53
1826,1693234109649,1692261845538,1692261845715,1693234109882,233,177,56
1827,1693234109883,1692261845779,1692261845954,1693234110123,240,175,65
1828,1693234110123,1692261846004,1692261846176,1693234110343,220,172,48
1829,1693234110344,1692261846220,1692261846393,1693234110561,217,173,44
1830,1693234110561,1692261846453,1692261846623,1693234110791,230,170,60
1831,1693234110791,1692261846684,1692261846855,1693234111022,231,171,60
1832,1693234111022,1692261846885,1692261847054,1693234111222,200,169,31
1833,1693234111222,1692261847111,1692261847282,1693234111452,230,171,59
1834,1693234111452,1692261847335,1692261847507,1693234111675,223,172,51
1835,1693234111675,1692261847567,1692261847740,1693234111907,232,173,59
1836,1693234111907,1692261847781,1692261847954,1693234112121,214,173,41
1837,1693234112121,1692261848002,1692261848175,1693234112343,222,173,49
1838,1693234112343,1692261848215,1692261848387,1693234112554,211,172,39
1839,1693234112554,1692261848416,1692261848588,1693234112756,202,172,30
1840,1693234112756,1692261848646,1692261848819,1693234112991,235,173,62
1841,1693234112992,1692261848867,1692261849038,1693234113206,214,171,43
1842,1693234113206,1692261849062,1692261849233,1693234113401,195,171,24
1843,1693234113401,1692261849278,1692261849448,1693234113616,215,170,45
1844,1693234113616,1692261849492,1692261849665,1693234113832,216,173,43
1845,1693234113833,1692261849706,1692261849876,1693234114043,210,170,40
1846,1693234114043,1692261849924,1692261850095,1693234114263,220,171,49
1847,1693234114263,1692261850132,1692261850303,1693234114471,208,171,37
1848,1693234114471,1692261850345,1692261850518,1693234114685,214,173,41
1849,1693234114685,1692261850567,1692261850740,1693234114907,222,173,49
1850,1693234114907,1692261850779,1692261850949,1693234115116,209,170,39
1851,1693234115116,1692261850993,1692261851165,1693234115332,216,172,44
1852,1693234115338,1692261851207,1692261851377,1693234115544,206,170,36
1853,1693234115544,1692261851430,1692261851603,1693234115770,226,173,53
1854,1693234115770,1692261851655,1692261851827,1693234115995,225,172,53
1855,1693234115995,1692261851869,1692261852040,1693234116207,212,171,41
1856,1693234116207,1692261852079,1692261852252,1693234116419,212,173,39
1857,1693234116419,1692261852310,1692261852482,1693234116649,230,172,58
1858,1693234116649,1692261852542,1692261852717,1693234116884,235,175,60
1859,1693234116884,1692261852756,1692261852929,1693234117096,212,173,39
1860,1693234117096,1692261852983,1692261853156,1693234117323,227,173,54
1861,1693234117324,1692261853189,1692261853359,1693234117526,202,170,32
1862,1693234117527,1692261853396,1692261853567,1693234117734,207,171,36
1863,1693234117734,1692261853605,1692261853776,1693234117944,210,171,39
1864,1693234117944,1692261853824,1692261853995,1693234118162,218,171,47
1865,1693234118162,1692261854034,1692261854206,1693234118373,211,172,39
1866,1693234118373,1692261854263,1692261854435,1693234118602,229,172,57
1867,1693234118602,1692261854474,1692261854645,1693234118812,210,171,39
1868,1693234118812,1692261854685,1692261854857,1693234119024,212,172,40
1869,1693234119024,1692261854901,1692261855072,1693234119239,215,171,44
1870,1693234119239,1692261855123,1692261855296,1693234119463,224,173,51
1871,1693234119463,1692261855347,1692261855520,1693234119687,224,173,51
1872,1693234119687,1692261855564,1692261855736,1693234119905,218,172,46
1873,1693234119905,1692261855797,1692261855970,1693234120137,232,173,59
1874,1693234120137,1692261856009,1692261856179,1693234120346,209,170,39
1875,1693234120346,1692261856223,1692261856395,1693234120568,222,172,50
1876,1693234120568,1692261856437,1692261856607,1693234120774,206,170,36
1877,1693234120774,1692261856650,1692261856824,1693234120994,220,174,46
1878,1693234120994,1692261856883,1692261857058,1693234121226,232,175,57
1879,1693234121226,1692261857100,1692261857270,1693234121439,213,170,43
1880,1693234121440,1692261857330,1692261857503,1693234121670,230,173,57
1881,1693234121670,1692261857545,1692261857718,1693234121886,216,173,43
1882,1693234121886,1692261857765,1692261857936,1693234122103,217,171,46
1883,1693234122103,1692261858007,1692261858180,1693234122365,262,173,89
1884,1693234122366,1692261858242,1692261858412,1693234122580,214,170,44
1885,1693234122580,1692261858507,1692261858681,1693234122848,268,174,94
1886,1693234122848,1692261858724,1692261858894,1693234123061,213,170,43
1887,1693234123061,1692261858954,1692261859127,1693234123294,233,173,60
1888,1693234123294,1692261859186,1692261859359,1693234123526,232,173,59
1889,1693234123526,1692261859403,1692261859574,1693234123741,215,171,44
1890,1693234123741,1692261859599,1692261859768,1693234123935,194,169,25
1891,1693234123935,1692261859810,1692261859982,1693234124149,214,172,42
1892,1693234124149,1692261860014,1692261860184,1693234124351,202,170,32
1893,1693234124351,1692261860216,1692261860386,1693234124553,202,170,32
1894,1693234124553,1692261860443,1692261860616,1693234124786,233,173,60
1895,1693234124786,1692261860649,1692261860819,1693234124986,200,170,30
1896,1693234124986,1692261860864,1692261861036,1693234125203,217,172,45
1897,1693234125203,1692261861094,1692261861266,1693234125434,231,172,59
1898,1693234125434,1692261861307,1692261861479,1693234125646,212,172,40
1899,1693234125646,1692261861504,1692261861674,1693234125841,195,170,25
1900,1693234125841,1692261861711,1692261861882,1693234126049,208,171,37
1901,1693234126049,1692261861923,1692261862097,1693234126264,215,174,41
1902,1693234126264,1692261862132,1692261862304,1693234126471,207,172,35
1903,1693234126471,1692261862348,1692261862521,1693234126688,217,173,44
1904,1693234126688,1692261862568,1692261862740,1693234126907,219,172,47
1905,1693234126907,1692261862782,1692261862953,1693234127120,213,171,42
1906,1693234127120,1692261863001,1692261863174,1693234127341,221,173,48
1907,1693234127341,1692261863213,1692261863384,1693234127552,211,171,40
1908,1693234127552,1692261863420,1692261863592,1693234127759,207,172,35
1909,1693234127759,1692261863628,1692261863798,1693234127965,206,170,36
1910,1693234127966,1692261863823,1692261863992,1693234128159,193,169,24
1911,1693234128160,1692261864024,1692261864194,1693234128361,201,170,31
1912,1693234128361,1692261864231,1692261864402,1693234128569,208,171,37
1913,1693234128569,1692261864444,1692261864617,1693234128786,217,173,44
1914,1693234128786,1692261864652,1692261864822,1693234128990,204,170,34
1915,1693234128990,1692261864881,1692261865055,1693234129223,233,174,59
1916,1693234129223,1692261865093,1692261865267,1693234129434,211,174,37
1917,1693234129434,1692261865333,1692261865507,1693234129674,240,174,66
1918,1693234129674,1692261865546,1692261865717,1693234129886,212,171,41
1919,1693234129886,1692261865771,1692261865944,1693234130115,229,173,56
1920,1693234130115,1692261866011,1692261866182,1693234130349,234,171,63
1921,1693234130349,1692261866220,1692261866391,1693234130558,209,171,38
1922,1693234130558,1692261866443,1692261866614,1693234130781,223,171,52
1923,1693234130781,1692261866648,1692261866817,1693234130984,203,169,34
1924,1693234130984,1692261866866,1692261867036,1693234131204,220,170,50
1925,1693234131204,1692261867080,1692261867252,1693234131420,216,172,44
1926,1693234131420,1692261867315,1692261867486,1693234131657,237,171,66
1927,1693234131657,1692261867532,1692261867707,1693234131874,217,175,42
1928,1693234131874,1692261867746,1692261867918,1693234132085,211,172,39
1929,1693234132085,1692261867951,1692261868120,1693234132287,202,169,33
1930,1693234132287,1692261868154,1692261868322,1693234132489,202,168,34
1931,1693234132489,1692261868356,1692261868526,1693234132693,204,170,34
1932,1693234132693,1692261868591,1692261868762,1693234132930,237,171,66
1933,1693234132930,1692261868826,1692261868998,1693234133165,235,172,63
1934,1693234133165,1692261869029,1692261869198,1693234133366,201,169,32
1935,1693234133366,1692261869247,1692261869421,1693234133588,222,174,48
1936,1693234133588,1692261869461,1692261869632,1693234133799,211,171,40
1937,1693234133800,1692261869669,1692261869840,1693234134007,207,171,36
1938,1693234134007,1692261869877,1692261870049,1693234134217,210,172,38
1939,1693234134217,1692261870087,1692261870256,1693234134463,246,169,77
1940,1693234134463,1692261870346,1692261870517,1693234134684,221,171,50
1941,1693234134684,1692261870569,1692261870741,1693234134908,224,172,52
1942,1693234134908,1692261870772,1692261870941,1693234135108,200,169,31
1943,1693234135108,1692261870979,1692261871148,1693234135315,207,169,38
1944,1693234135315,1692261871182,1692261871349,1693234135518,203,167,36
1945,1693234135518,1692261871403,1692261871577,1693234135744,226,174,52
1946,1693234135744,1692261871617,1692261871788,1693234135955,211,171,40
1947,1693234135955,1692261871830,1692261872001,1693234136168,213,171,42
1948,1693234136168,1692261872046,1692261872220,1693234136387,219,174,45
1949,1693234136387,1692261872257,1692261872429,1693234136596,209,172,37
1950,1693234136596,1692261872470,1692261872641,1693234136808,212,171,41
1951,1693234136808,1692261872691,1692261872862,1693234137029,221,171,50
1952,1693234137029,1692261872904,1692261873075,1693234137242,213,171,42
1953,1693234137242,1692261873123,1692261873295,1693234137465,223,172,51
1954,1693234137465,1692261873348,1692261873519,1693234137686,221,171,50
1955,1693234137686,1692261873583,1692261873758,1693234137925,239,175,64
1956,1693234137925,1692261873813,1692261873985,1693234138152,227,172,55
1957,1693234138152,1692261874025,1692261874197,1693234138364,212,172,40
1958,1693234138364,1692261874258,1692261874433,1693234138600,236,175,61
1959,1693234138600,1692261874475,1692261874645,1693234138812,212,170,42
1960,1693234138812,1692261874689,1692261874861,1693234139028,216,172,44
1961,1693234139028,1692261874895,1692261875065,1693234139232,204,170,34
1962,1693234139232,1692261875109,1692261875279,1693234139446,214,170,44
1963,1693234139446,1692261875321,1692261875492,1693234139679,233,171,62
1964,1693234139679,1692261875553,1692261875724,1693234139891,212,171,41
1965,1693234139891,1692261875769,1692261875942,1693234140109,218,173,45
1966,1693234140109,1692261875988,1692261876161,1693234140331,222,173,49
1967,1693234140331,1692261876222,1692261876396,1693234140564,233,174,59
1968,1693234140564,1692261876444,1692261876616,1693234140784,220,172,48
1969,1693234140784,1692261876671,1692261876842,1693234141009,225,171,54
1970,1693234141009,1692261876892,1692261877063,1693234141231,222,171,51
1971,1693234141231,1692261877098,1692261877267,1693234141435,204,169,35
1972,1693234141435,1692261877299,1692261877466,1693234141634,199,167,32
1973,1693234141634,1692261877512,1692261877682,1693234141849,215,170,45
1974,1693234141849,1692261877729,1692261877900,1693234142069,220,171,49
1975,1693234142069,1692261877950,1692261878124,1693234142291,222,174,48
1976,1693234142291,1692261878160,1692261878331,1693234142498,207,171,36
1977,1693234142498,1692261878382,1692261878555,1693234142722,224,173,51
1978,1693234142722,1692261878599,1692261878771,1693234142938,216,172,44
1979,1693234142938,1692261878802,1692261878971,1693234143138,200,169,31
1980,1693234143138,1692261879015,1692261879185,1693234143352,214,170,44
1981,1693234143353,1692261879223,1692261879398,1693234143565,212,175,37
1982,1693234143565,1692261879429,1692261879598,1693234143765,200,169,31
1983,1693234143765,1692261879659,1692261879830,1693234143998,233,171,62
1984,1693234143998,1692261879903,1692261880074,1693234144241,243,171,72
1985,1693234144241,1692261880119,1692261880290,1693234144457,216,171,45
1986,1693234144457,1692261880329,1692261880502,1693234144668,211,173,38
1987,1693234144668,1692261880543,1692261880716,1693234144883,215,173,42
1988,1693234144883,1692261880810,1692261880986,1693234145154,271,176,95
1989,1693234145154,1692261881032,1692261881203,1693234145370,216,171,45
1990,1693234145541,1692261881415,1692261881774,1693234145941,400,359,41
1991,1693234145941,1692261881822,1692261882152,1693234146319,378,330,48
1992,1693234146319,1692261882202,1692261882527,1693234146739,420,325,95
1993,1693234146739,1692261882625,1692261882944,1693234147111,372,319,53
1994,1693234147111,1692261882977,1692261883265,1693234147432,321,288,33
1995,1693234147432,1692261883313,1692261883485,1693234147652,220,172,48
1996,1693234147652,1692261883531,1692261883704,1693234147871,219,173,46
1997,1693234147871,1692261883757,1692261883931,1693234148098,227,174,53
1998,1693234148098,1692261883980,1692261884151,1693234148318,220,171,49
1999,1693234148318,1692261884200,1692261884371,1693234148538,220,171,49
2000,1693234148538,1692261884408,1692261884580,1693234148747,209,172,37
2001,1693234148747,1692261884630,1692261884801,1693234148968,221,171,50
2002,1693234148968,1692261884860,1692261885033,1693234149201,233,173,60
2003,1693234149201,1692261885094,1692261885265,1693234149464,263,171,92
2004,1693234149464,1692261885358,1692261885533,1693234149702,238,175,63
2005,1693234149702,1692261885603,1692261885777,1693234149944,242,174,68
2006,1693234149944,1692261885845,1692261886020,1693234150187,243,175,68
2007,1693234150187,1692261886057,1692261886229,1693234150397,210,172,38
2008,1693234150397,1692261886263,1692261886432,1693234150599,202,169,33
2009,1693234150599,1692261886482,1692261886654,1693234150821,222,172,50
2010,1693234150821,1692261886699,1692261886872,1693234151039,218,173,45
2011,1693234151039,1692261886909,1692261887078,1693234151251,212,169,43
2012,1693234151251,1692261887131,1692261887304,1693234151471,220,173,47
2013,1693234151471,1692261887365,1692261887537,1693234151709,238,172,66
2014,1693234151709,1692261887580,1692261887752,1693234151919,210,172,38
2015,1693234151919,1692261887788,1692261887959,1693234152136,217,171,46
2016,1693234152136,1692261888017,1692261888190,1693234152357,221,173,48
2017,1693234152358,1692261888238,1692261888411,1693234152578,220,173,47
2018,1693234152578,1692261888456,1692261888629,1693234152796,218,173,45
2019,1693234152796,1692261888692,1692261888864,1693234153035,239,172,67
2020,1693234153035,1692261888923,1692261889097,1693234153264,229,174,55
2021,1693234153264,1692261889137,1692261889307,1693234153474,210,170,40
2022,1693234153474,1692261889341,1692261889512,1693234153679,205,171,34
2023,1693234153679,1692261889555,1692261889725,1693234153894,215,170,45
2024,1693234153894,1692261889758,1692261889929,1693234154096,202,171,31
2025,1693234154097,1692261889973,1692261890145,1693234154313,216,172,44
2026,1693234154313,1692261890185,1692261890359,1693234154526,213,174,39
2027,1693234154526,1692261890401,1692261890580,1693234154747,221,179,42
2028,1693234154747,1692261890616,1692261890798,1693234154966,219,182,37
2029,1693234154966,1692261890849,1692261891183,1693234155350,384,334,50
2030,1693234155350,1692261891240,1692261891573,1693234155740,390,333,57
2031,1693234155740,1692261891607,1692261891820,1693234155987,247,213,34
2032,1693234155987,1692261891884,1692261892176,1693234156343,356,292,64
2033,1693234156343,1692261892222,1692261892395,1693234156563,220,173,47
2034,1693234156563,1692261892453,1692261892625,1693234156791,228,172,56
2035,1693234156792,1692261892655,1692261892824,1693234156991,199,169,30
2036,1693234156991,1692261892866,1692261893037,1693234157208,217,171,46
2037,1693234157208,1692261893074,1692261893246,1693234157413,205,172,33
2038,1693234157413,1692261893278,1692261893448,1693234157615,202,170,32
2039,1693234157615,1692261893494,1692261893666,1693234157833,218,172,46
2040,1693234157833,1692261893722,1692261893895,1693234158063,230,173,57
2041,1693234158063,1692261893936,1692261894106,1693234158274,211,170,41
2042,1693234158274,1692261894167,1692261894339,1693234158506,232,172,60
2043,1693234158506,1692261894376,1692261894548,1693234158715,209,172,37
2044,1693234158715,1692261894602,1692261894774,1693234158941,226,172,54
2045,1693234158941,1692261894823,1692261894994,1693234159161,220,171,49
2046,1693234159161,1692261895155,1692261895329,1693234159495,334,174,160
2047,1693234159495,1692261895375,1692261895547,1693234159716,221,172,49
2048,1693234159716,1692261895606,1692261895777,1693234160110,394,171,223
2049,1693234160110,1692261895979,1692261896152,1693234160319,209,173,36
2050,1693234160319,1692261896207,1692261896379,1693234160555,236,172,64
2051,1693234160555,1692261896422,1692261896593,1693234160760,205,171,34
2052,1693234160760,1692261896633,1692261896805,1693234160972,212,172,40
2053,1693234160972,1692261896836,1692261897005,1693234161172,200,169,31
2054,1693234161172,1692261897034,1692261897204,1693234161371,199,170,29
2055,1693234161371,1692261897273,1692261897445,1693234161612,241,172,69
2056,1693234161612,1692261897526,1692261897698,1693234161865,253,172,81
2057,1693234161865,1692261897739,1692261897910,1693234162077,212,171,41
2058,1693234162077,1692261897979,1692261898153,1693234162319,242,174,68
2059,1693234162319,1692261898187,1692261898357,1693234162524,205,170,35
2060,1693234162524,1692261898394,1692261898565,1693234162732,208,171,37
2061,1693234162732,1692261898613,1692261898787,1693234162954,222,174,48
2062,1693234162954,1692261898830,1692261899001,1693234163167,213,171,42
2063,1693234163168,1692261899029,1692261899214,1693234163381,213,185,28
2064,1693234163381,1692261899253,1692261899432,1693234163599,218,179,39
2065,1693234163599,1692261899493,1692261899831,1693234163998,399,338,61
2066,1693234163998,1692261899886,1692261900092,1693234164259,261,206,55
2067,1693234164259,1692261900137,1692261900310,1693234164477,218,173,45
2068,1693234164477,1692261900346,1692261900521,1693234164688,211,175,36
2069,1693234164688,1692261900589,1692261900759,1693234164926,238,170,68
2070,1693234164926,1692261900829,1692261901000,1693234165167,241,171,70
2071,1693234165167,1692261901030,1692261901198,1693234165365,198,168,30
2072,1693234165365,1692261901230,1692261901399,1693234165566,201,169,32
2073,1693234165566,1692261901451,1692261901623,1693234165790,224,172,52
2074,1693234165790,1692261901692,1692261901866,1693234166035,245,174,71
2075,1693234166036,1692261901915,1692261902086,1693234166253,217,171,46
2076,1693234166253,1692261902118,1692261902287,1693234166454,201,169,32
2077,1693234166455,1692261902317,1692261902488,1693234166655,200,171,29
2078,1693234166655,1692261902528,1692261902699,1693234166866,211,171,40
2079,1693234166866,1692261902741,1692261902911,1693234167078,212,170,42
2080,1693234167078,1692261902964,1692261903138,1693234167307,229,174,55
2081,1693234167307,1692261903210,1692261903383,1693234167550,243,173,70
2082,1693234167550,1692261903429,1692261903603,1693234167774,224,174,50
2083,1693234167774,1692261903650,1692261903820,1693234167987,213,170,43
2084,1693234167987,1692261903862,1692261904036,1693234168203,216,174,42
2085,1693234168203,1692261904099,1692261904272,1693234168438,235,173,62
2086,1693234168438,1692261904313,1692261904485,1693234168652,214,172,42
2087,1693234168652,1692261904519,1692261904691,1693234168857,205,172,33
2088,1693234168857,1692261904725,1692261904897,1693234169063,206,172,34
2089,1693234169064,1692261904925,1692261905095,1693234169261,197,170,27
2090,1693234169261,1692261905130,1692261905300,1693234169467,206,170,36
2091,1693234169467,1692261905359,1692261905530,1693234169697,230,171,59
2092,1693234169697,1692261905613,1692261905794,1693234169961,264,181,83
2093,1693234169961,1692261905866,1692261906039,1693234170205,244,173,71
2094,1693234170205,1692261906098,1692261906269,1693234170436,231,171,60
2095,1693234170436,1692261906300,1692261906469,1693234170639,203,169,34
2096,1693234170639,1692261906508,1692261906720,1693234170888,249,212,37
2097,1693234170888,1692261906762,1692261906945,1693234171112,224,183,41
2098,1693234171112,1692261906978,1692261907233,1693234171400,288,255,33
2099,1693234171400,1692261907416,1692261907590,1693234171758,358,174,184
2100,1693234171759,1692261907628,1692261907802,1693234171969,210,174,36
2101,1693234171969,1692261907843,1692261908019,1693234172186,217,176,41
2102,1693234172186,1692261908062,1692261908234,1693234172401,215,172,43
2103,1693234172401,1692261908305,1692261908475,1693234172642,241,170,71
2104,1693234172642,1692261908538,1692261908711,1693234172877,235,173,62
2105,1693234172877,1692261908755,1692261908926,1693234173104,227,171,56
2106,1693234173104,1692261908961,1692261909130,1693234173297,193,169,24
2107,1693234173297,1692261909176,1692261909350,1693234173516,219,174,45
2108,1693234173516,1692261909396,1692261909567,1693234173734,218,171,47
2109,1693234173734,1692261909623,1692261909796,1693234173962,228,173,55
2110,1693234173962,1692261909833,1692261910004,1693234174170,208,171,37
2111,1693234174171,1692261910054,1692261910227,1693234174394,223,173,50
2112,1693234174394,1692261910268,1692261910440,1693234174607,213,172,41
2113,1693234174607,1692261910483,1692261910653,1693234174819,212,170,42
2114,1693234174819,1692261910709,1692261910882,1693234175048,229,173,56
2115,1693234175048,1692261910916,1692261911085,1693234175251,203,169,34
2116,1693234175252,1692261911118,1692261911289,1693234175456,204,171,33
2117,1693234175456,1692261911329,1692261911501,1693234175668,212,172,40
2118,1693234175675,1692261911565,1692261911736,1693234175903,228,171,57
2119,1693234175903,1692261911798,1692261911970,1693234176137,234,172,62
2120,1693234176137,1692261912020,1692261912191,1693234176357,220,171,49
2121,1693234176357,1692261912233,1692261912405,1693234176572,215,172,43
2122,1693234176572,1692261912440,1692261912609,1693234176775,203,169,34
2123,1693234176775,1692261912657,1692261912828,1693234176995,220,171,49
2124,1693234176995,1692261912868,1692261913039,1693234177206,211,171,40
2125,1693234177206,1692261913066,1692261913236,1693234177403,197,170,27
2126,1693234177403,1692261913311,1692261913486,1693234177652,249,175,74
2127,1693234177653,1692261913555,1692261913732,1693234177899,246,177,69
2128,1693234177899,1692261913787,1692261913959,1693234178125,226,172,54
2129,1693234178125,1692261913990,1692261914161,1693234178328,203,171,32
2130,1693234178328,1692261914192,1692261914361,1693234178527,199,169,30
2131,1693234178527,1692261914403,1692261914571,1693234178738,211,168,43
2132,1693234178738,1692261914618,1692261914790,1693234178957,219,172,47
2133,1693234178957,1692261914858,1692261915032,1693234179199,242,174,68
2134,1693234179199,1692261915062,1692261915231,1693234179398,199,169,30
2135,1693234179398,1692261915302,1692261915477,1693234179666,268,175,93
2136,1693234179666,1692261915531,1692261915703,1693234179870,204,172,32
2137,1693234179871,1692261915735,1692261915906,1693234180072,201,171,30
2138,1693234180072,1692261915941,1692261916110,1693234180277,205,169,36
2139,1693234180277,1692261916138,1692261916309,1693234180476,199,171,28
2140,1693234180476,1692261916347,1692261916515,1693234180681,205,168,37
2141,1693234180681,1692261916556,1692261916729,1693234180896,215,173,42
2142,1693234180896,1692261916776,1692261916945,1693234181112,216,169,47
2143,1693234181112,1692261916988,1692261917161,1693234181327,215,173,42
2144,1693234181327,1692261917218,1692261917392,1693234181559,232,174,58
2145,1693234181559,1692261917451,1692261917625,1693234181792,233,174,59
2146,1693234181792,1692261917670,1692261917843,1693234182009,217,173,44
2147,1693234182009,1692261917889,1692261918059,1693234182225,216,170,46
2148,1693234182225,1692261918103,1692261918275,1693234182442,217,172,45
2149,1693234182442,1692261918302,1692261918472,1693234182639,197,170,27
2150,1693234182639,1692261918495,1692261918665,1693234182832,193,170,23
2151,1693234182832,1692261918730,1692261918903,1693234183070,238,173,65
2152,1693234183070,1692261918944,1692261919114,1693234183280,210,170,40
2153,1693234183280,1692261919163,1692261919335,1693234183501,221,172,49
2154,1693234183501,1692261919392,1692261919564,1693234183731,230,172,58
2155,1693234183731,1692261919607,1692261919779,1693234183945,214,172,42
2156,1693234183945,1692261919848,1692261920022,1693234184188,243,174,69
2157,1693234184189,1692261920083,1692261920254,1693234184421,232,171,61
2158,1693234184421,1692261920315,1692261920488,1693234184655,234,173,61
2159,1693234184655,1692261920530,1692261920702,1693234184875,220,172,48
2160,1693234184875,1692261920745,1692261920915,1693234185082,207,170,37
2161,1693234185082,1692261920949,1692261921118,1693234185284,202,169,33
2162,1693234185284,1692261921173,1692261921343,1693234185510,226,170,56
2163,1693234185510,1692261921378,1692261921550,1693234185717,207,172,35
2164,1693234185717,1692261921591,1692261921762,1693234185928,211,171,40
2165,1693234185928,1692261921788,1692261921957,1693234186124,196,169,27
2166,1693234186124,1692261921996,1692261922169,1693234186335,211,173,38
2167,1693234186336,1692261922222,1692261922393,1693234186559,223,171,52
2168,1693234186559,1692261922438,1692261922610,1693234186777,218,172,46
2169,1693234186777,1692261922652,1692261922825,1693234186991,214,173,41
2170,1693234186991,1692261922881,1692261923051,1693234187218,227,170,57
2171,1693234187218,1692261923089,1692261923261,1693234187427,209,172,37
2172,1693234187427,1692261923303,1692261923472,1693234187639,212,169,43
2173,1693234187639,1692261923505,1692261923674,1693234187841,202,169,33
2174,1693234187841,1692261923731,1692261923903,1693234188069,228,172,56
2175,1693234188069,1692261923944,1692261924115,1693234188282,213,171,42
2176,1693234188282,1692261924155,1692261924327,1693234188494,212,172,40
2177,1693234188494,1692261924369,1692261924541,1693234188707,213,172,41
2178,1693234188707,1692261924579,1692261924749,1693234188916,209,170,39
2179,1693234188916,1692261924782,1692261924951,1693234189118,202,169,33
2180,1693234189118,1692261925019,1692261925191,1693234189357,239,172,67
2181,1693234189357,1692261925257,1692261925429,1693234189595,238,172,66
2182,1693234189595,1692261925466,1692261925636,1693234189803,208,170,38
2183,1693234189803,1692261925697,1692261925870,1693234190036,233,173,60
2184,1693234190036,1692261925906,1692261926077,1693234190243,207,171,36
2185,1693234190243,1692261926115,1692261926286,1693234190454,211,171,40
2186,1693234190454,1692261926342,1692261926514,1693234190680,226,172,54
2187,1693234190681,1692261926568,1692261926739,1693234190906,225,171,54
2188,1693234190906,1692261926794,1692261926967,1693234191134,228,173,55
2189,1693234191134,1692261927013,1692261927185,1693234191352,218,172,46
2190,1693234191352,1692261927238,1692261927409,1693234191576,224,171,53
2191,1693234191576,1692261927448,1692261927619,1693234191786,210,171,39
2192,1693234191786,1692261927690,1692261927862,1693234192028,242,172,70
2193,1693234192028,1692261927896,1692261928066,1693234192233,205,170,35
2194,1693234192233,1692261928097,1692261928265,1693234192431,198,168,30
2195,1693234192432,1692261928313,1692261928484,1693234192656,224,171,53
2196,1693234192656,1692261928524,1692261928696,1693234192862,206,172,34
2197,1693234192862,1692261928751,1692261928923,1693234193090,228,172,56
2198,1693234193090,1692261928969,1692261929141,1693234193307,217,172,45
2199,1693234193307,1692261929185,1692261929359,1693234193525,218,174,44
2200,1693234193525,1692261929390,1692261929560,1693234193727,202,170,32
2201,1693234193727,1692261929632,1692261929806,1693234193973,246,174,72
2202,1693234193973,1692261929854,1692261930025,1693234194191,218,171,47
2203,1693234194191,1692261930078,1692261930251,1693234194417,226,173,53
2204,1693234194417,1692261930341,1692261930513,1693234194680,263,172,91
2205,1693234194680,1692261930552,1692261930723,1693234194890,210,171,39
2206,1693234194890,1692261930772,1692261930944,1693234195113,223,172,51
2207,1693234195113,1692261930986,1692261931158,1693234195325,212,172,40
2208,1693234195325,1692261931206,1692261931378,1693234195545,220,172,48
2209,1693234195545,1692261931414,1692261931585,1693234195752,207,171,36
2210,1693234195752,1692261931616,1692261931787,1693234195954,202,171,31
2211,1693234195954,1692261931823,1692261931994,1693234196161,207,171,36
2212,1693234196161,1692261932057,1692261932228,1693234196394,233,171,62
2213,1693234196394,1692261932284,1692261932456,1693234196622,228,172,56
2214,1693234196622,1692261932503,1692261932675,1693234196841,219,172,47
2215,1693234196841,1692261932736,1692261932908,1693234197074,233,172,61
2216,1693234197074,1692261932963,1692261933138,1693234197304,230,175,55
2217,1693234197304,1692261933228,1692261933399,1693234197570,266,171,95
2218,1693234197570,1692261933465,1692261933637,1693234197806,236,172,64
2219,1693234197806,1692261933680,1692261933855,1693234198021,215,175,40
2220,1693234198021,1692261933876,1692261934045,1693234198211,190,169,21
2221,1693234198211,1692261934094,1692261934265,1693234198432,221,171,50
2222,1693234198432,1692261934317,1692261934489,1693234198656,224,172,52
2223,1693234198656,1692261934549,1692261934723,1693234198890,234,174,60
2224,1693234198890,1692261934780,1692261934953,1693234199119,229,173,56
2225,1693234199120,1692261934998,1692261935171,1693234199337,217,173,44
2226,1693234199337,1692261935214,1692261935386,1693234199553,216,172,44
2227,1693234199553,1692261935419,1692261935587,1693234199754,201,168,33
2228,1693234199754,1692261935659,1692261935831,1693234199998,244,172,72
2229,1693234199998,1692261935897,1692261936069,1693234200235,237,172,65
2230,1693234200235,1692261936112,1692261936282,1693234200449,214,170,44
2231,1693234200449,1692261936309,1692261936478,1693234200644,195,169,26
2232,1693234200644,1692261936523,1692261936694,1693234200860,216,171,45
2233,1693234200860,1692261936753,1692261936926,1693234201093,233,173,60
2234,1693234201093,1692261936958,1692261937128,1693234201294,201,170,31
2235,1693234201294,1692261937162,1692261937331,1693234201498,204,169,35
2236,1693234201498,1692261937374,1692261937546,1693234201712,214,172,42
2237,1693234201712,1692261937594,1692261937765,1693234201931,219,171,48
2238,1693234201931,1692261937832,1692261938004,1693234202171,240,172,68
2239,1693234202171,1692261938031,1692261938201,1693234202368,197,170,27
2240,1693234202368,1692261938258,1692261938430,1693234202597,229,172,57
2241,1693234202597,1692261938476,1692261938647,1693234202814,217,171,46
2242,1693234202814,1692261938682,1692261938851,1693234203017,203,169,34
2243,1693234203017,1692261938894,1692261939066,1693234203232,215,172,43
2244,1693234203232,1692261939116,1692261939288,1693234203454,222,172,50
2245,1693234203455,1692261939330,1692261939501,1693234203668,213,171,42
2246,1693234203668,1692261939562,1692261939736,1693234203902,234,174,60
2247,1693234203902,1692261939768,1692261939941,1693234204108,206,173,33
2248,1693234204108,1692261940003,1692261940175,1693234204341,233,172,61
2249,1693234204341,1692261940212,1692261940385,1693234204551,210,173,37
2250,1693234204551,1692261940421,1692261940590,1693234204757,206,169,37
2251,1693234204757,1692261940645,1692261940818,1693234204984,227,173,54
2252,1693234204984,1692261940868,1692261941040,1693234205206,222,172,50
2253,1693234205206,1692261941096,1692261941269,1693234205436,230,173,57
2254,1693234205436,1692261941314,1692261941485,1693234205652,216,171,45
2255,1693234205652,1692261941529,1692261941702,1693234205869,217,173,44
2256,1693234206041,1692261941919,1692261942266,1693234206432,391,347,44
2257,1693234206432,1692261942285,1692261942615,1693234206785,353,330,23
2258,1693234206785,1692261942650,1692261942991,1693234207157,372,341,31
2259,1693234207157,1692261943038,1692261943372,1693234207538,381,334,47
2260,1693234207538,1692261943415,1692261943629,1693234207796,258,214,44
2261,1693234207796,1692261943665,1692261943845,1693234208013,217,180,37
2262,1693234208013,1692261943885,1692261944056,1693234208223,210,171,39
2263,1693234208223,1692261944089,1692261944258,1693234208424,201,169,32
2264,1693234208424,1692261944301,1692261944472,1693234208638,214,171,43
2265,1693234208638,1692261944514,1692261944686,1693234208852,214,172,42
2266,1693234208852,1692261944732,1692261944902,1693234209068,216,170,46
2267,1693234209068,1692261944931,1692261945100,1693234209267,199,169,30
2268,1693234209267,1692261945146,1692261945318,1693234209484,217,172,45
2269,1693234209484,1692261945385,1692261945556,1693234209723,239,171,68
2270,1693234209723,1692261945622,1692261945795,1693234209961,238,173,65
2271,1693234209961,1692261945834,1692261946007,1693234210173,212,173,39
2272,1693234210173,1692261946058,1692261946230,1693234210397,224,172,52
2273,1693234210397,1692261946279,1692261946451,1693234210617,220,172,48
2274,1693234210617,1692261946486,1692261946659,1693234210824,207,173,34
2275,1693234210824,1692261946710,1692261946883,1693234211049,225,173,52
2276,1693234211049,1692261946920,1692261947092,1693234211258,209,172,37
2277,1693234211258,1692261947120,1692261947289,1693234211456,198,169,29
2278,1693234211456,1692261947346,1692261947519,1693234211685,229,173,56
2279,1693234211685,1692261947567,1692261947738,1693234211905,220,171,49
2280,1693234211905,1692261947771,1692261947940,1693234212111,206,169,37
2281,1693234212111,1692261948000,1692261948170,1693234212336,225,170,55
2282,1693234212336,1692261948226,1692261948399,1693234212565,229,173,56
2283,1693234212565,1692261948425,1692261948594,1693234212760,195,169,26
2284,1693234212760,1692261948631,1692261948801,1693234212967,207,170,37
2285,1693234212967,1692261948847,1692261949019,1693234213185,218,172,46
2286,1693234213185,1692261949059,1692261949229,1693234213396,211,170,41
2287,1693234213396,1692261949280,1692261949450,1693234213617,221,170,51
2288,1693234213617,1692261949487,1692261949658,1693234213824,207,171,36
2289,1693234213824,1692261949692,1692261949861,1693234214027,203,169,34
2290,1693234214027,1692261949930,1692261950111,1693234214278,251,181,70
2291,1693234214278,1692261950147,1692261950321,1693234214487,209,174,35
2292,1693234214487,1692261950350,1692261950521,1693234214687,200,171,29
2293,1693234214687,1692261950575,1692261950748,1693234214914,227,173,54
2294,1693234214914,1692261950810,1692261950984,1693234215150,236,174,62
2295,1693234215150,1692261951032,1692261951203,1693234215369,219,171,48
2296,1693234215369,1692261951244,1692261951415,1693234215581,212,171,41
2297,1693234215581,1692261951444,1692261951624,1693234215791,210,180,30
2298,1693234215791,1692261951672,1692261951845,1693234216013,222,173,49
2299,1693234216013,1692261951874,1692261952044,1693234216211,198,170,28
2300,1693234216211,1692261952085,1692261952258,1693234216424,213,173,40
2301,1693234216424,1692261952295,1692261952465,1693234216631,207,170,37
2302,1693234216631,1692261952508,1692261952684,1693234216851,220,176,44
2303,1693234216851,1692261952724,1692261952896,1693234217063,212,172,40
2304,1693234217063,1692261952950,1692261953126,1693234217292,229,176,53
2305,1693234217292,1692261953157,1692261953330,1693234217496,204,173,31
2306,1693234217496,1692261953368,1692261953546,1693234217714,218,178,40
2307,1693234217714,1692261953587,1692261953757,1693234217923,209,170,39
2308,1693234217923,1692261953821,1692261953993,1693234218160,237,172,65
2309,1693234218160,1692261954024,1692261954193,1693234218359,199,169,30
2310,1693234218359,1692261954255,1692261954427,1693234218593,234,172,62
2311,1693234218593,1692261954464,1692261954634,1693234218800,207,170,37
2312,1693234218800,1692261954662,1692261954832,1693234218999,199,170,29
2313,1693234218999,1692261954869,1692261955038,1693234219204,205,169,36
2314,1693234219204,1692261955106,1692261955280,1693234219446,242,174,68
2315,1693234219446,1692261955332,1692261955505,1693234219672,226,173,53
2316,1693234219672,1692261955558,1692261955729,1693234219895,223,171,52
2317,1693234219895,1692261955843,1692261956012,1693234220178,283,169,114
2318,1693234220178,1692261956059,1692261956229,1693234220395,217,170,47
2319,1693234220395,1692261956288,1692261956459,1693234220625,230,171,59
2320,1693234220625,1692261956497,1692261956667,1693234220833,208,170,38
2321,1693234220833,1692261956710,1692261956881,1693234221047,214,171,43
2322,1693234221047,1692261956917,1692261957087,1693234221253,206,170,36
2323,1693234221253,1692261957124,1692261957293,1693234221459,206,169,37
2324,1693234221459,1692261957335,1692261957505,1693234221671,212,170,42
2325,1693234221671,1692261957546,1692261957719,1693234221885,214,173,41
2326,1693234221885,1692261957748,1692261957928,1693234222094,209,180,29
2327,1693234222095,1692261957969,1692261958141,1693234222307,212,172,40
2328,1693234222307,1692261958178,1692261958349,1693234222515,208,171,37
2329,1693234222515,1692261958397,1692261958569,1693234222735,220,172,48
2330,1693234222735,1692261958615,1692261958788,1693234222955,220,173,47
2331,1693234222955,1692261958817,1692261958987,1693234223154,199,170,29
2332,1693234223154,1692261959054,1692261959231,1693234223397,243,177,66
2333,1693234223397,1692261959287,1692261959459,1693234223625,228,172,56
2334,1693234223625,1692261959506,1692261959679,1693234223845,220,173,47
2335,1693234223845,1692261959742,1692261959919,1693234224085,240,177,63
2336,1693234224085,1692261959967,1692261960139,1693234224305,220,172,48
2337,1693234224305,1692261960178,1692261960349,1693234224515,210,171,39
2338,1693234224515,1692261960420,1692261960593,1693234224760,245,173,72
2339,1693234224760,1692261960639,1692261960809,1693234224975,215,170,45
2340,1693234224975,1692261960840,1692261961008,1693234225174,199,168,31
2341,1693234225174,1692261961059,1692261961230,1693234225396,222,171,51
2342,1693234225396,1692261961253,1692261961424,1693234225590,194,171,23
2343,1693234225590,1692261961483,1692261961655,1693234225821,231,172,59
2344,1693234225821,1692261961700,1692261961873,1693234226039,218,173,45
2345,1693234226039,1692261961923,1692261962095,1693234226262,223,172,51
2346,1693234226262,1692261962168,1692261962340,1693234226507,245,172,73
2347,1693234226507,1692261962376,1692261962547,1693234226714,207,171,36
2348,1693234226714,1692261962583,1692261962754,1693234226920,206,171,35
2349,1693234226920,1692261962808,1692261962978,1693234227146,226,170,56
2350,1693234227146,1692261963054,1692261963226,1693234227392,246,172,74
2351,1693234227392,1692261963282,1692261963452,1693234227618,226,170,56
2352,1693234227618,1692261963493,1692261963666,1693234227832,214,173,41
2353,1693234227832,1692261963698,1692261963870,1693234228036,204,172,32
2354,1693234228036,1692261963908,1692261964079,1693234228245,209,171,38
2355,1693234228245,1692261964127,1692261964301,1693234228467,222,174,48
2356,1693234228467,1692261964340,1692261964510,1693234228676,209,170,39
2357,1693234228676,1692261964551,1692261964726,1693234228892,216,175,41
2358,1693234228892,1692261964769,1692261964956,1693234229123,231,187,44
2359,1693234229123,1692261965020,1692261965199,1693234229365,242,179,63
2360,1693234229365,1692261965221,1692261965390,1693234229556,191,169,22
2361,1693234229556,1692261965424,1692261965598,1693234229764,208,174,34
2362,1693234229764,1692261965628,1692261965801,1693234229967,203,173,30
2363,1693234229967,1692261965816,1692261965986,1693234230152,185,170,15
2364,1693234230153,1692261966043,1692261966222,1693234230389,236,179,57
2365,1693234230389,1692261966278,1692261966456,1693234230622,233,178,55
2366,1693234230622,1692261966519,1692261966689,1693234230855,233,170,63
2367,1693234230855,1692261966745,1692261966922,1693234231088,233,177,56
2368,1693234231088,1692261966947,1692261967122,1693234231288,200,175,25
2369,1693234231288,1692261967181,1692261967352,1693234231518,230,171,59
2370,1693234231518,1692261967386,1692261967559,1693234231726,208,173,35
2371,1693234231726,1692261967600,1692261967771,1693234231937,211,171,40
2372,1693234231937,1692261967797,1692261967968,1693234232134,197,171,26
2373,1693234232134,1692261967997,1692261968166,1693234232332,198,169,29
2374,1693234232332,1692261968194,1692261968366,1693234232532,200,172,28
2375,1693234232532,1692261968417,1692261968591,1693234232757,225,174,51
2376,1693234232757,1692261968623,1692261968791,1693234232957,200,168,32
2377,1693234232958,1692261968873,1692261969047,1693234233213,255,174,81
2378,1693234233213,1692261969075,1692261969245,1693234233411,198,170,28
2379,1693234233411,1692261969296,1692261969467,1693234233633,222,171,51
2380,1693234233633,1692261969525,1692261969697,1693234233863,230,172,58
2381,1693234233863,1692261969727,1692261969897,1693234234063,200,170,30
2382,1693234234063,1692261969939,1692261970112,1693234234278,215,173,42
2383,1693234234278,1692261970179,1692261970351,1693234234517,239,172,67
2384,1693234234517,1692261970434,1692261970608,1693234234774,257,174,83
2385,1693234234774,1692261970647,1692261970819,1693234234985,211,172,39
2386,1693234234986,1692261970846,1692261971016,1693234235182,196,170,26
2387,1693234235182,1692261971057,1692261971229,1693234235395,213,172,41
2388,1693234235396,1692261971272,1692261971444,1693234235611,215,172,43
2389,1693234235611,1692261971478,1692261971647,1693234235813,202,169,33
2390,1693234235813,1692261971719,1692261971893,1693234236059,246,174,72
2391,1693234236066,1692261971970,1692261972147,1693234236314,248,177,71
2392,1693234236314,1692261972175,1692261972346,1693234236512,198,171,27
2393,1693234236512,1692261972374,1692261972544,1693234236711,199,170,29
2394,1693234236711,1692261972577,1692261972747,1693234236913,202,170,32
2395,1693234236913,1692261972785,1692261972954,1693234237120,207,169,38
2396,1693234237120,1692261972985,1692261973153,1693234237319,199,168,31
2397,1693234237319,1692261973187,1692261973357,1693234237523,204,170,34
2398,1693234237523,1692261973390,1692261973558,1693234237724,201,168,33
2399,1693234237724,1692261973584,1692261973752,1693234237918,194,168,26
2400,1693234237919,1692261973784,1692261973953,1693234238122,203,169,34
2401,1693234238122,1692261974026,1692261974199,1693234238365,243,173,70
2402,1693234238365,1692261974238,1692261974409,1693234238575,210,171,39
2403,1693234238575,1692261974471,1692261974646,1693234238812,237,175,62
2404,1693234238812,1692261974708,1692261974882,1693234239049,237,174,63
2405,1693234239049,1692261974914,1692261975082,1693234239248,199,168,31
2406,1693234239248,1692261975127,1692261975300,1693234239466,218,173,45
2407,1693234239466,1692261975352,1692261975526,1693234239692,226,174,52
2408,1693234239692,1692261975562,1692261975734,1693234239900,208,172,36
2409,1693234239900,1692261975780,1692261975954,1693234240120,220,174,46
2410,1693234240120,1692261975989,1692261976163,1693234240329,209,174,35
2411,1693234240329,1692261976205,1692261976378,1693234240544,215,173,42
2412,1693234240544,1692261976411,1692261976581,1693234240747,203,170,33
2413,1693234240747,1692261976622,1692261976794,1693234240960,213,172,41
2414,1693234240960,1692261976840,1692261977011,1693234241177,217,171,46
2415,1693234241178,1692261977049,1692261977218,1693234241384,206,169,37
2416,1693234241384,1692261977259,1692261977432,1693234241599,215,173,42
2417,1693234241599,1692261977468,1692261977638,1693234241807,208,170,38
2418,1693234241807,1692261977679,1692261977850,1693234242016,209,171,38
2419,1693234242016,1692261977885,1692261978053,1693234242219,203,168,35
2420,1693234242220,1692261978112,1692261978284,1693234242454,234,172,62
2421,1693234242454,1692261978318,1692261978488,1693234242654,200,170,30
2422,1693234242654,1692261978522,1692261978690,1693234242860,206,168,38
2423,1693234242860,1692261978721,1692261978892,1693234243058,198,171,27
2424,1693234243058,1692261978930,1692261979100,1693234243266,208,170,38
2425,1693234243266,1692261979143,1692261979315,1693234243480,214,172,42
2426,1693234243481,1692261979377,1692261979549,1693234243715,234,172,62
2427,1693234243715,1692261979615,1692261979787,1693234243957,242,172,70
2428,1693234243957,1692261979835,1692261980006,1693234244172,215,171,44
2429,1693234244172,1692261980072,1692261980245,1693234244411,239,173,66
2430,1693234244411,1692261980282,1692261980451,1693234244617,206,169,37
2431,1693234244617,1692261980491,1692261980665,1693234244831,214,174,40
2432,1693234244831,1692261980700,1692261980870,1693234245036,205,170,35
2433,1693234245036,1692261980920,1692261981093,1693234245259,223,173,50
2434,1693234245259,1692261981126,1692261981297,1693234245463,204,171,33
2435,1693234245463,1692261981334,1692261981505,1693234245671,208,171,37
2436,1693234245671,1692261981578,1692261981752,1693234245918,247,174,73
2437,1693234245918,1692261981828,1692261982001,1693234246166,248,173,75
2438,1693234246167,1692261982026,1692261982199,1693234246365,198,173,25
2439,1693234246365,1692261982238,1692261982409,1693234246575,210,171,39
2440,1693234246575,1692261982471,1692261982642,1693234246808,233,171,62
2441,1693234246808,1692261982687,1692261982860,1693234247029,221,173,48
2442,1693234247029,1692261982920,1692261983094,1693234247260,231,174,57
2443,1693234247260,1692261983121,1692261983292,1693234247458,198,171,27
2444,1693234247458,1692261983345,1692261983520,1693234247686,228,175,53
2445,1693234247686,1692261983562,1692261983734,1693234247900,214,172,42
2446,1693234247900,1692261983757,1692261983927,1693234248093,193,170,23
2447,1693234248093,1692261983983,1692261984158,1693234248323,230,175,55
2448,1693234248323,1692261984191,1692261984362,1693234248528,205,171,34
2449,1693234248528,1692261984395,1692261984564,1693234248729,201,169,32
2450,1693234248729,1692261984617,1692261984788,1693234248953,224,171,53
2451,1693234248953,1692261984825,1692261984997,1693234249163,210,172,38
2452,1693234249163,1692261985034,1692261985203,1693234249369,206,169,37
2453,1693234249369,1692261985244,1692261985417,1693234249582,213,173,40
2454,1693234249582,1692261985456,1692261985631,1693234249797,215,175,40
2455,1693234249797,1692261985673,1692261985844,1693234250218,421,171,250
2456,1693234250219,1692261986078,1692261986249,1693234250415,196,171,25
2457,1693234250415,1692261986292,1692261986464,1693234250630,215,172,43
2458,1693234250630,1692261986512,1692261986683,1693234250849,219,171,48
2459,1693234250849,1692261986727,1692261986900,1693234251066,217,173,44
2460,1693234251066,1692261986940,1692261987110,1693234251276,210,170,40
2461,1693234251276,1692261987158,1692261987330,1693234251496,220,172,48
2462,1693234251496,1692261987358,1692261987527,1693234251693,197,169,28
2463,1693234251693,1692261987592,1692261987767,1693234251932,239,175,64
2464,1693234251933,1692261987815,1692261987989,1693234252160,227,174,53
2465,1693234252160,1692261988013,1692261988182,1693234252348,188,169,19
2466,1693234252348,1692261988222,1692261988391,1693234252558,210,169,41
2467,1693234252558,1692261988443,1692261988615,1693234252781,223,172,51
2468,1693234252781,1692261988658,1692261988828,1693234252994,213,170,43
2469,1693234252994,1692261988857,1692261989026,1693234253192,198,169,29
2470,1693234253192,1692261989081,1692261989252,1693234253418,226,171,55
2471,1693234253418,1692261989294,1692261989467,1693234253633,215,173,42
2472,1693234253633,1692261989499,1692261989669,1693234253835,202,170,32
2473,1693234253835,1692261989729,1692261989903,1693234254069,234,174,60
2474,1693234254069,1692261989927,1692261990099,1693234254265,196,172,24
2475,1693234254265,1692261990139,1692261990313,1693234254479,214,174,40
2476,1693234254479,1692261990356,1692261990526,1693234254692,213,170,43
2477,1693234254692,1692261990556,1692261990725,1693234254891,199,169,30
2478,1693234254891,1692261990784,1692261990957,1693234255125,234,173,61
2479,1693234255125,1692261991017,1692261991191,1693234255357,232,174,58
2480,1693234255357,1692261991246,1692261991417,1693234255582,225,171,54
2481,1693234255582,1692261991473,1692261991645,1693234255811,229,172,57
2482,1693234255811,1692261991675,1692261991844,1693234256010,199,169,30
2483,1693234256010,1692261991890,1692261992062,1693234256228,218,172,46
2484,1693234256228,1692261992099,1692261992273,1693234256439,211,174,37
2485,1693234256439,1692261992342,1692261992516,1693234256683,244,174,70
2486,1693234256683,1692261992553,1692261992723,1693234256888,205,170,35
2487,1693234256889,1692261992761,1692261992934,1693234257149,260,173,87
2488,1693234257149,1692261993033,1692261993205,1693234257371,222,172,50
2489,1693234257371,1692261993239,1692261993408,1693234257575,204,169,35
2490,1693234257575,1692261993455,1692261993626,1693234257792,217,171,46
2491,1693234257792,1692261993677,1692261993848,1693234258014,222,171,51
2492,1693234258014,1692261993878,1692261994048,1693234258214,200,170,30
2493,1693234258214,1692261994083,1692261994252,1693234258419,205,169,36
2494,1693234258419,1692261994285,1692261994458,1693234258624,205,173,32
2495,1693234258624,1692261994520,1692261994692,1693234258858,234,172,62
2496,1693234258858,1692261994731,1692261994901,1693234259067,209,170,39
2497,1693234259067,1692261994961,1692261995134,1693234259300,233,173,60
2498,1693234259300,1692261995174,1692261995343,1693234259508,208,169,39
2499,1693234259508,1692261995394,1692261995566,1693234259731,223,172,51
2500,1693234259731,1692261995608,1692261995778,1693234259944,213,170,43
2501,1693234259945,1692261995830,1692261996004,1693234260184,239,174,65
2502,1693234260184,1692261996059,1692261996230,1693234260396,212,171,41
2503,1693234260396,1692261996286,1692261996458,1693234260624,228,172,56
2504,1693234260624,1692261996495,1692261996668,1693234260833,209,173,36
2505,1693234260833,1692261996707,1692261996879,1693234261045,212,172,40
2506,1693234261045,1692261996943,1692261997116,1693234261281,236,173,63
2507,1693234261281,1692261997170,1692261997342,1693234261508,227,172,55
2508,1693234261508,1692261997394,1692261997567,1693234261733,225,173,52
2509,1693234261733,1692261997614,1692261997786,1693234261952,219,172,47
2510,1693234261952,1692261997837,1692261998007,1693234262172,220,170,50
2511,1693234262172,1692261998062,1692261998235,1693234262402,230,173,57
2512,1693234262402,1692261998277,1692261998449,1693234262615,213,172,41
2513,1693234262615,1692261998495,1692261998668,1693234262837,222,173,49
2514,1693234262837,1692261998701,1692261998873,1693234263039,202,172,30
2515,1693234263039,1692261998946,1692261999119,1693234263285,246,173,73
2516,1693234263285,1692261999192,1692261999366,1693234263532,247,174,73
2517,1693234263532,1692261999409,1692261999581,1693234263747,215,172,43
2518,1693234263747,1692261999619,1692261999789,1693234263954,207,170,37
2519,1693234263954,1692261999821,1692261999990,1693234264156,202,169,33
2520,1693234264156,1692262000019,1692262000188,1693234264353,197,169,28
2521,1693234264353,1692262000244,1692262000417,1693234264583,230,173,57
2522,1693234264583,1692262000483,1692262000656,1693234264822,239,173,66
2523,1693234264822,1692262000716,1692262000889,1693234265055,233,173,60
2524,1693234265055,1692262000930,1692262001102,1693234265267,212,172,40
2525,1693234265267,1692262001163,1692262001335,1693234265501,234,172,62
2526,1693234265501,1692262001378,1692262001548,1693234265714,213,170,43
2527,1693234265715,1692262001588,1692262001760,1693234265926,211,172,39
2528,1693234265926,1692262001808,1692262001979,1693234266145,219,171,48
2529,1693234266314,1692262002220,1692262002504,1693234266670,356,284,72
2530,1693234266671,1692262002531,1692262002821,1693234266987,316,290,26
2531,1693234266987,1692262002861,1692262003187,1693234267407,420,326,94
2532,1693234267407,1692262003280,1692262003529,1693234267696,289,249,40
2533,1693234267696,1692262003558,1692262003849,1693234268014,318,291,27
2534,1693234268015,1692262003891,1692262004096,1693234268262,247,205,42
2535,1693234268263,1692262004137,1692262004307,1693234268473,210,170,40
2536,1693234268473,1692262004344,1692262004516,1693234268682,209,172,37
2537,1693234268682,1692262004555,1692262004725,1693234268891,209,170,39
2538,1693234268891,1692262004771,1692262004942,1693234269108,217,171,46
2539,1693234269108,1692262004993,1692262005162,1693234269328,220,169,51
2540,1693234269328,1692262005206,1692262005379,1693234269545,217,173,44
2541,1693234269545,1692262005422,1692262005593,1693234269759,214,171,43
2542,1693234269760,1692262005647,1692262005819,1693234269984,224,172,52
2543,1693234269984,1692262005850,1692262006019,1693234270185,201,169,32
2544,1693234270185,1692262006064,1692262006233,1693234270399,214,169,45
2545,1693234270399,1692262006271,1692262006441,1693234270606,207,170,37
2546,1693234270606,1692262006475,1692262006646,1693234270812,206,171,35
2547,1693234270812,1692262006706,1692262006878,1693234271044,232,172,60
2548,1693234271044,1692262006934,1692262007104,1693234271270,226,170,56
2549,1693234271270,1692262007153,1692262007323,1693234271489,219,170,49
2550,1693234271489,1692262007360,1692262007530,1693234271696,207,170,37
2551,1693234271696,1692262007571,1692262007744,1693234271909,213,173,40
2552,1693234271910,1692262007785,1692262007958,1693234272123,213,173,40
2553,1693234272123,1692262008011,1692262008186,1693234272351,228,175,53
2554,1693234272351,1692262008220,1692262008390,1693234272555,204,170,34
2555,1693234272556,1692262008430,1692262008602,1693234272768,212,172,40
2556,1693234272768,1692262008653,1692262008825,1693234272991,223,172,51
2557,1693234272991,1692262008865,1692262009034,1693234273200,209,169,40
2558,1693234273200,1692262009073,1692262009243,1693234273408,208,170,38
2559,1693234273408,1692262009312,1692262009483,1693234273652,244,171,73
2560,1693234273652,1692262009523,1692262009696,1693234273862,210,173,37
2561,1693234273862,1692262009741,1692262009912,1693234274077,215,171,44
2562,1693234274077,1692262009958,1692262010128,1693234274294,217,170,47
2563,1693234274294,1692262010169,1692262010340,1693234274506,212,171,41
2564,1693234274506,1692262010395,1692262010571,1693234274737,231,176,55
2565,1693234274737,1692262010599,1692262010768,1693234274934,197,169,28
2566,1693234274934,1692262010809,1692262010981,1693234275146,212,172,40
2567,1693234275146,1692262011020,1692262011191,1693234275356,210,171,39
2568,1693234275356,1692262011244,1692262011415,1693234275581,225,171,54
2569,1693234275581,1692262011460,1692262011648,1693234275814,233,188,45
2570,1693234275814,1692262011692,1692262011871,1693234276037,223,179,44
2571,1693234276037,1692262011924,1692262012100,1693234276265,228,176,52
2572,1693234276266,1692262012136,1692262012313,1693234276479,213,177,36
2573,1693234276479,1692262012349,1692262012524,1693234276690,211,175,36
2574,1693234276690,1692262012566,1692262012740,1693234276906,216,174,42
2575,1693234276906,1692262012776,1692262012953,1693234277119,213,177,36
2576,1693234277119,1692262012992,1692262013172,1693234277338,219,180,39
2577,1693234277338,1692262013197,1692262013373,1693234277541,203,176,27
2578,1693234277541,1692262013420,1692262013591,1693234277757,216,171,45
2579,1693234277757,1692262013637,1692262013809,1693234277975,218,172,46
2580,1693234277975,1692262013856,1692262014028,1693234278193,218,172,46
2581,1693234278193,1692262014070,1692262014242,1693234278407,214,172,42
2582,1693234278407,1692262014283,1692262014455,1693234278621,214,172,42
2583,1693234278621,1692262014515,1692262014689,1693234278854,233,174,59
2584,1693234278854,1692262014751,1692262014924,1693234279090,236,173,63
2585,1693234279090,1692262014971,1692262015144,1693234279309,219,173,46
2586,1693234279309,1692262015177,1692262015348,1693234279513,204,171,33
2587,1693234279513,1692262015388,1692262015559,1693234279725,212,171,41
2588,1693234279725,1692262015622,1692262015797,1693234280128,403,175,228
2589,1693234280128,1692262016004,1692262016174,1693234280340,212,170,42
2590,1693234280340,1692262016222,1692262016393,1693234280558,218,171,47
2591,1693234280559,1692262016434,1692262016608,1693234280774,215,174,41
2592,1693234280774,1692262016643,1692262016814,1693234280980,206,171,35
2593,1693234280980,1692262016849,1692262017021,1693234281186,206,172,34
2594,1693234281186,1692262017055,1692262017223,1693234281389,203,168,35
2595,1693234281389,1692262017267,1692262017441,1693234281607,218,174,44
2596,1693234281607,1692262017473,1692262017645,1693234281810,203,172,31
2597,1693234281810,1692262017705,1692262017876,1693234282041,231,171,60
2598,1693234282041,1692262017924,1692262018098,1693234282264,223,174,49
2599,1693234282264,1692262018127,1692262018300,1693234282465,201,173,28
2600,1693234282465,1692262018330,1692262018501,1693234282666,201,171,30
2601,1693234282666,1692262018543,1692262018716,1693234282882,216,173,43
2602,1693234282882,1692262018758,1692262018932,1693234283098,216,174,42
2603,1693234283098,1692262018990,1692262019163,1693234283328,230,173,57
2604,1693234283328,1692262019207,1692262019381,1693234283547,219,174,45
2605,1693234283547,1692262019413,1692262019581,1693234283747,200,168,32
2606,1693234283747,1692262019618,1692262019793,1693234283963,216,175,41
2607,1693234283963,1692262019832,1692262020009,1693234284174,211,177,34
2608,1693234284174,1692262020071,1692262020273,1693234284439,265,202,63
2609,1693234284439,1692262020314,1692262020489,1693234284655,216,175,41
2610,1693234284655,1692262020524,1692262020698,1693234284864,209,174,35
2611,1693234284864,1692262020745,1692262020915,1693234285081,217,170,47
2612,1693234285081,1692262020968,1692262021140,1693234285318,237,172,65
2613,1693234285318,1692262021180,1692262021351,1693234285516,198,171,27
2614,1693234285516,1692262021402,1692262021575,1693234285740,224,173,51
2615,1693234285740,1692262021614,1692262021785,1693234285951,211,171,40
2616,1693234285951,1692262021818,1692262021987,1693234286153,202,169,33
2617,1693234286153,1692262022036,1692262022208,1693234286374,221,172,49
2618,1693234286374,1692262022250,1692262022421,1693234286586,212,171,41
2619,1693234286586,1692262022478,1692262022651,1693234286817,231,173,58
2620,1693234286817,1692262022685,1692262022856,1693234287022,205,171,34
2621,1693234287022,1692262022899,1692262023071,1693234287237,215,172,43
2622,1693234287237,1692262023134,1692262023306,1693234287479,242,172,70
2623,1693234287479,1692262023365,1692262023539,1693234287704,225,174,51
2624,1693234287704,1692262023570,1692262023739,1693234287904,200,169,31
2625,1693234287904,1692262023783,1692262023956,1693234288122,218,173,45
2626,1693234288122,1692262023984,1692262024154,1693234288319,197,170,27
2627,1693234288320,1692262024189,1692262024358,1693234288523,203,169,34
2628,1693234288524,1692262024420,1692262024592,1693234288758,234,172,62
2629,1693234288758,1692262024641,1692262024811,1693234288977,219,170,49
2630,1693234288977,1692262024835,1692262025007,1693234289173,196,172,24
2631,1693234289173,1692262025056,1692262025232,1693234289397,224,176,48
2632,1693234289397,1692262025277,1692262025448,1693234289616,219,171,48
2633,1693234289616,1692262025488,1692262025659,1693234289824,208,171,37
2634,1693234289825,1692262025708,1692262025880,1693234290045,220,172,48
2635,1693234290045,1692262025920,1692262026092,1693234290257,212,172,40
2636,1693234290257,1692262026124,1692262026299,1693234290465,208,175,33
2637,1693234290465,1692262026340,1692262026516,1693234290681,216,176,40
2638,1693234290681,1692262026575,1692262026747,1693234290913,232,172,60
2639,1693234290913,1692262026806,1692262026980,1693234291145,232,174,58
2640,1693234291145,1692262027028,1692262027221,1693234291387,242,193,49
2641,1693234291387,1692262027274,1692262027454,1693234291620,233,180,53
2642,1693234291620,1692262027498,1692262027673,1693234291839,219,175,44
2643,1693234291839,1692262027734,1692262027908,1693234292074,235,174,61
2644,1693234292074,1692262027956,1692262028127,1693234292293,219,171,48
2645,1693234292293,1692262028169,1692262028340,1693234292506,213,171,42
2646,1693234292506,1692262028370,1692262028544,1693234292710,204,174,30
2647,1693234292710,1692262028586,1692262028755,1693234292921,211,169,42
2648,1693234292921,1692262028809,1692262028982,1693234293147,226,173,53
2649,1693234293147,1692262029015,1692262029184,1693234293350,203,169,34
2650,1693234293350,1692262029214,1692262029384,1693234293549,199,170,29
2651,1693234293549,1692262029438,1692262029610,1693234293775,226,172,54
2652,1693234293775,1692262029650,1692262029822,1693234293988,213,172,41
2653,1693234293988,1692262029861,1692262030032,1693234294198,210,171,39
2654,1693234294198,1692262030070,1692262030240,1693234294407,209,170,39
2655,1693234294407,1692262030305,1692262030476,1693234294642,235,171,64
2656,1693234294642,1692262030515,1692262030689,1693234294854,212,174,38
2657,1693234294854,1692262030724,1692262030893,1693234295058,204,169,35
2658,1693234295058,1692262030930,1692262031100,1693234295266,208,170,38
2659,1693234295266,1692262031121,1692262031290,1693234295455,189,169,20
2660,1693234295455,1692262031349,1692262031524,1693234295689,234,175,59
2661,1693234295689,1692262031573,1692262031744,1693234295909,220,171,49
2662,1693234295909,1692262031806,1692262031979,1693234296144,235,173,62
2663,1693234296145,1692262032009,1692262032179,1693234296345,200,170,30
2664,1693234296352,1692262032238,1692262032410,1693234296575,223,172,51
2665,1693234296575,1692262032475,1692262032653,1693234296819,244,178,66
2666,1693234296819,1692262032698,1692262032869,1693234297034,215,171,44
2667,1693234297034,1692262032910,1692262033081,1693234297246,212,171,41
2668,1693234297246,1692262033113,1692262033283,1693234297448,202,170,32
2669,1693234297448,1692262033330,1692262033503,1693234297668,220,173,47
2670,1693234297668,1692262033541,1692262033714,1693234297879,211,173,38
2671,1693234297879,1692262033775,1692262033947,1693234298113,234,172,62
2672,1693234298113,1692262033980,1692262034151,1693234298317,204,171,33
2673,1693234298317,1692262034204,1692262034378,1693234298543,226,174,52
2674,1693234298543,1692262034417,1692262034589,1693234298755,212,172,40
2675,1693234298755,1692262034624,1692262034795,1693234298961,206,171,35
2676,1693234298961,1692262034828,1692262034997,1693234299162,201,169,32
2677,1693234299162,1692262035047,1692262035218,1693234299384,222,171,51
2678,1693234299384,1692262035258,1692262035428,1693234299593,209,170,39
2679,1693234299593,1692262035485,1692262035659,1693234299824,231,174,57
2680,1693234299824,1692262035692,1692262035862,1693234300027,203,170,33
2681,1693234300027,1692262035890,1692262036059,1693234300225,198,169,29
2682,1693234300225,1692262036103,1692262036276,1693234300442,217,173,44
2683,1693234300442,1692262036324,1692262036494,1693234300660,218,170,48
2684,1693234300660,1692262036559,1692262036731,1693234300896,236,172,64
2685,1693234300896,1692262036780,1692262036953,1693234301118,222,173,49
2686,1693234301118,1692262036992,1692262037162,1693234301327,209,170,39
2687,1693234301327,1692262037209,1692262037382,1693234301547,220,173,47
2688,1693234301547,1692262037435,1692262037606,1693234301771,224,171,53
2689,1693234301771,1692262037636,1692262037806,1693234301976,205,170,35
2690,1693234301976,1692262037850,1692262038018,1693234302184,208,168,40
2691,1693234302184,1692262038091,1692262038266,1693234302441,257,175,82
2692,1693234302441,1692262038333,1692262038507,1693234302672,231,174,57
2693,1693234302672,1692262038548,1692262038722,1693234302887,215,174,41
2694,1693234302887,1692262038763,1692262038934,1693234303099,212,171,41
2695,1693234303099,1692262038968,1692262039139,1693234303304,205,171,34
2696,1693234303304,1692262039181,1692262039352,1693234303518,214,171,43
2697,1693234303518,1692262039397,1692262039568,1693234303734,216,171,45
2698,1693234303734,1692262039611,1692262039781,1693234303947,213,170,43
2699,1693234303947,1692262039820,1692262039994,1693234304159,212,174,38
2700,1693234304159,1692262040045,1692262040217,1693234304382,223,172,51
2701,1693234304382,1692262040243,1692262040413,1693234304579,197,170,27
2702,1693234304579,1692262040466,1692262040640,1693234304806,227,174,53
2703,1693234304806,1692262040688,1692262040861,1693234305026,220,173,47
2704,1693234305026,1692262040899,1692262041070,1693234305235,209,171,38
2705,1693234305235,1692262041100,1692262041269,1693234305435,200,169,31
2706,1693234305435,1692262041329,1692262041502,1693234305667,232,173,59
2707,1693234305667,1692262041569,1692262041741,1693234305907,240,172,68
2708,1693234305907,1692262041794,1692262041966,1693234306131,224,172,52
2709,1693234306131,1692262041999,1692262042171,1693234306336,205,172,33
2710,1693234306336,1692262042236,1692262042409,1693234306574,238,173,65
2711,1693234306574,1692262042451,1692262042623,1693234306789,215,172,43
2712,1693234306789,1692262042679,1692262042852,1693234307017,228,173,55
2713,1693234307017,1692262042898,1692262043070,1693234307239,222,172,50
2714,1693234307240,1692262043113,1692262043285,1693234307451,211,172,39
2715,1693234307451,1692262043315,1692262043485,1693234307651,200,170,30
2716,1693234307651,1692262043533,1692262043703,1693234307868,217,170,47
2717,1693234307868,1692262043739,1692262043908,1693234308074,206,169,37
2718,1693234308074,1692262043956,1692262044128,1693234308293,219,172,47
2719,1693234308293,1692262044173,1692262044345,1693234308510,217,172,45
2720,1693234308510,1692262044379,1692262044548,1693234308714,204,169,35
2721,1693234308714,1692262044582,1692262044750,1693234308915,201,168,33
2722,1693234308915,1692262044798,1692262044971,1693234309136,221,173,48
2723,1693234309137,1692262045031,1692262045204,1693234309369,232,173,59
2724,1693234309369,1692262045283,1692262045458,1693234309623,254,175,79
2725,1693234309623,1692262045509,1692262045681,1693234309847,224,172,52
2726,1693234309847,1692262045967,1692262046137,1693234310302,455,170,285
2727,1693234310302,1692262046189,1692262046360,1693234310525,223,171,52
2728,1693234310525,1692262046404,1692262046575,1693234310740,215,171,44
2729,1693234310740,1692262046610,1692262046782,1693234310947,207,172,35
2730,1693234310947,1692262046816,1692262046985,1693234311150,203,169,34
2731,1693234311151,1692262047042,1692262047215,1693234311381,230,173,57
2732,1693234311381,1692262047250,1692262047423,1693234311588,207,173,34
2733,1693234311588,1692262047486,1692262047656,1693234311822,234,170,64
2734,1693234311822,1692262047718,1692262047891,1693234312057,235,173,62
2735,1693234312057,1692262047928,1692262048098,1693234312264,207,170,37
2736,1693234312264,1692262048136,1692262048307,1693234312472,208,171,37
2737,1693234312472,1692262048355,1692262048526,1693234312692,220,171,49
2738,1693234312692,1692262048582,1692262048754,1693234312919,227,172,55
2739,1693234312919,1692262048819,1692262048993,1693234313158,239,174,65
2740,1693234313158,1692262049034,1692262049205,1693234313371,213,171,42
2741,1693234313371,1692262049254,1692262049426,1693234313594,223,172,51
2742,1693234313594,1692262049486,1692262049660,1693234313825,231,174,57
2743,1693234313825,1692262049706,1692262049877,1693234314042,217,171,46
2744,1693234314042,1692262049910,1692262050079,1693234314244,202,169,33
2745,1693234314244,1692262050117,1692262050289,1693234314455,211,172,39
2746,1693234314455,1692262050338,1692262050510,1693234314675,220,172,48
2747,1693234314675,1692262050543,1692262050712,1693234314877,202,169,33
2748,1693234314877,1692262050752,1692262050922,1693234315087,210,170,40
2749,1693234315087,1692262050969,1692262051142,1693234315308,221,173,48
2750,1693234315308,1692262051183,1692262051356,1693234315522,214,173,41
2751,1693234315522,1692262051420,1692262051596,1693234315761,239,176,63
2752,1693234315761,1692262051629,1692262051801,1693234315966,205,172,33
2753,1693234315966,1692262051834,1692262052002,1693234316168,202,168,34
2754,1693234316168,1692262052044,1692262052214,1693234316379,211,170,41
2755,1693234316379,1692262052241,1692262052412,1693234316577,198,171,27
2756,1693234316577,1692262052462,1692262052632,1693234316798,221,170,51
2757,1693234316798,1692262052665,1692262052834,1693234316999,201,169,32
2758,1693234316999,1692262052888,1692262053059,1693234317224,225,171,54
2759,1693234317224,1692262053102,1692262053275,1693234317440,216,173,43
2760,1693234317440,1692262053335,1692262053507,1693234317672,232,172,60
2761,1693234317672,1692262053556,1692262053731,1693234317896,224,175,49
2762,1693234317896,1692262053784,1692262053958,1693234318124,228,174,54
2763,1693234318124,1692262054005,1692262054176,1693234318341,217,171,46
2764,1693234318341,1692262054211,1692262054380,1693234318546,205,169,36
2765,1693234318546,1692262054411,1692262054581,1693234318746,200,170,30
2766,1693234318746,1692262054624,1692262054795,1693234318960,214,171,43
2767,1693234318960,1692262054829,1692262055001,1693234319166,206,172,34
2768,1693234319166,1692262055033,1692262055204,1693234319369,203,171,32
2769,1693234319369,1692262055241,1692262055412,1693234319578,209,171,38
2770,1693234319578,1692262055475,1692262055647,1693234319813,235,172,63
2771,1693234319813,1692262055711,1692262055885,1693234320050,237,174,63
2772,1693234320050,1692262055927,1692262056100,1693234320266,216,173,43
2773,1693234320266,1692262056138,1692262056308,1693234320473,207,170,37
2774,1693234320473,1692262056354,1692262056526,1693234320691,218,172,46
2775,1693234320691,1692262056563,1692262056734,1693234320899,208,171,37
2776,1693234320899,1692262056779,1692262056950,1693234321115,216,171,45
2777,1693234321115,1692262057018,1692262057192,1693234321357,242,174,68
2778,1693234321357,1692262057229,1692262057400,1693234321565,208,171,37
2779,1693234321565,1692262057452,1692262057626,1693234321791,226,174,52
2780,1693234321791,1692262057668,1692262057839,1693234322005,214,171,43
2781,1693234322005,1692262057886,1692262058059,1693234322225,220,173,47
2782,1693234322225,1692262058096,1692262058267,1693234322432,207,171,36
2783,1693234322432,1692262058291,1692262058459,1693234322625,193,168,25
2784,1693234322625,1692262058493,1692262058663,1693234322829,204,170,34
2785,1693234322829,1692262058690,1692262058861,1693234323026,197,171,26
2786,1693234323026,1692262058901,1692262059070,1693234323235,209,169,40
2787,1693234323235,1692262059113,1692262059284,1693234323450,215,171,44
2788,1693234323450,1692262059326,1692262059496,1693234323661,211,170,41
2789,1693234323661,1692262059511,1692262059681,1693234323846,185,170,15
2790,1693234323846,1692262059711,1692262059881,1693234324046,200,170,30
2791,1693234324046,1692262059907,1692262060080,1693234324245,199,173,26
2792,1693234324245,1692262060153,1692262060328,1693234324493,248,175,73
2793,1693234324494,1692262060404,1692262060577,1693234324742,248,173,75
2794,1693234324742,1692262060605,1692262060774,1693234324940,198,169,29
2795,1693234324940,1692262060813,1692262060984,1693234325150,210,171,39
2796,1693234325150,1692262061026,1692262061196,1693234325361,211,170,41
2797,1693234325361,1692262061247,1692262061418,1693234325584,223,171,52
2798,1693234325584,1692262061487,1692262061661,1693234325826,242,174,68
2799,1693234325826,1692262061703,1692262061875,1693234326040,214,172,42
2800,1693234326040,1692262061907,1692262062077,1693234326242,202,170,32
2801,1693234326242,1692262062116,1692262062288,1693234326453,211,172,39
