request_number,request_time_ms,request_received_time_ms,response_time_ms,response_received_time_ms,end_to_end_latency,compute_time,transmission_time
1,1693238283108,1692266019125,1692266019296,1693238283432,324,171,153
2,1693238283432,1692266019362,1692266019531,1693238283658,226,169,57
3,1693238283658,1692266019585,1692266019754,1693238283880,222,169,53
4,1693238283880,1692266019793,1692266019964,1693238284090,210,171,39
5,1693238284090,1692266020100,1692266020269,1693238284395,305,169,136
6,1693238284395,1692266020322,1692266020495,1693238284621,226,173,53
7,1693238284621,1692266020542,1692266020706,1693238284831,210,164,46
8,1693238284831,1692266020748,1692266020910,1693238285034,203,162,41
9,1693238285034,1692266020954,1692266021118,1693238285243,209,164,45
10,1693238285243,1692266021171,1692266021334,1693238285458,215,163,52
11,1693238285458,1692266021382,1692266021545,1693238285669,211,163,48
12,1693238285669,1692266021591,1692266021754,1693238285878,209,163,46
13,1693238285878,1692266021803,1692266021966,1693238286090,212,163,49
14,1693238286090,1692266022015,1692266022178,1693238286302,212,163,49
15,1693238286302,1692266022243,1692266022408,1693238286532,230,165,65
16,1693238286533,1692266022459,1692266022623,1693238286748,215,164,51
17,1693238286748,1692266022662,1692266022825,1693238286949,201,163,38
18,1693238286949,1692266022880,1692266023043,1693238287167,218,163,55
19,1693238287168,1692266023087,1692266023250,1693238287374,206,163,43
20,1693238287374,1692266023316,1692266023481,1693238287605,231,165,66
21,1693238287605,1692266023515,1692266023677,1693238287802,197,162,35
22,1693238287802,1692266023729,1692266023891,1693238288015,213,162,51
23,1693238288015,1692266023919,1692266024081,1693238288205,190,162,28
24,1693238288205,1692266024162,1692266024327,1693238288452,247,165,82
25,1693238288452,1692266024382,1692266024545,1693238288669,217,163,54
26,1693238288669,1692266024603,1692266024767,1693238288891,222,164,58
27,1693238288891,1692266024851,1692266025016,1693238289141,250,165,85
28,1693238289141,1692266025099,1692266025264,1693238289388,247,165,82
29,1693238289388,1692266025317,1692266025479,1693238289607,219,162,57
30,1693238289607,1692266025549,1692266025712,1693238289836,229,163,66
31,1693238289836,1692266025761,1692266025925,1693238290049,213,164,49
32,1693238290049,1692266025965,1692266026127,1693238290251,202,162,40
33,1693238290251,1692266026202,1692266026369,1693238290493,242,167,75
34,1693238290493,1692266026460,1692266026624,1693238290748,255,164,91
35,1693238290749,1692266026685,1692266026847,1693238290971,222,162,60
36,1693238290971,1692266026931,1692266027094,1693238291218,247,163,84
37,1693238291218,1692266027140,1692266027303,1693238291427,209,163,46
38,1693238291427,1692266027364,1692266027527,1693238291651,224,163,61
39,1693238291651,1692266027575,1692266027738,1693238291862,211,163,48
40,1693238291862,1692266027801,1692266027965,1693238292089,227,164,63
41,1693238292089,1692266028018,1692266028183,1693238292308,219,165,54
42,1693238292308,1692266028230,1692266028396,1693238292520,212,166,46
43,1693238292520,1692266028437,1692266028599,1693238292723,203,162,41
44,1693238292723,1692266028685,1692266028848,1693238292972,249,163,86
45,1693238292972,1692266028916,1692266029079,1693238293204,232,163,69
46,1693238293204,1692266029134,1692266029298,1693238293422,218,164,54
47,1693238293422,1692266029352,1692266029514,1693238293661,239,162,77
48,1693238293661,1692266029591,1692266029753,1693238293878,217,162,55
49,1693238293878,1692266029808,1692266029970,1693238294096,218,162,56
50,1693238294096,1692266030013,1692266030177,1693238294301,205,164,41
51,1693238294301,1692266030215,1692266030377,1693238294500,199,162,37
52,1693238294500,1692266030412,1692266030575,1693238294699,199,163,36
53,1693238294699,1692266030618,1692266030781,1693238294905,206,163,43
54,1693238294905,1692266030843,1692266031006,1693238295131,226,163,63
55,1693238295131,1692266031052,1692266031215,1693238295339,208,163,45
56,1693238295340,1692266031249,1692266031410,1693238295534,194,161,33
57,1693238295534,1692266031453,1692266031615,1693238295739,205,162,43
58,1693238295739,1692266031675,1692266031840,1693238295966,227,165,62
59,1693238295966,1692266031881,1692266032044,1693238296169,203,163,40
60,1693238296169,1692266032097,1692266032260,1693238296385,216,163,53
61,1693238296385,1692266032327,1692266032492,1693238296616,231,165,66
62,1693238296616,1692266032529,1692266032691,1693238296816,200,162,38
63,1693238296816,1692266032730,1692266032893,1693238297017,201,163,38
64,1693238297017,1692266032909,1692266033072,1693238297196,179,163,16
65,1693238297196,1692266033152,1692266033316,1693238297440,244,164,80
66,1693238297440,1692266033368,1692266033532,1693238297656,216,164,52
67,1693238297656,1692266033592,1692266033754,1693238297879,223,162,61
68,1693238297879,1692266033780,1692266033941,1693238298066,187,161,26
69,1693238298066,1692266033996,1692266034161,1693238298285,219,165,54
70,1693238298285,1692266034214,1692266034381,1693238298505,220,167,53
71,1693238298505,1692266034418,1692266034580,1693238298704,199,162,37
72,1693238298704,1692266034627,1692266034789,1693238298913,209,162,47
73,1693238298913,1692266034834,1692266034997,1693238299121,208,163,45
74,1693238299121,1692266035080,1692266035244,1693238299368,247,164,83
75,1693238299368,1692266035293,1692266035456,1693238299580,212,163,49
76,1693238299580,1692266035470,1692266035632,1693238299756,176,162,14
77,1693238299756,1692266035670,1692266035832,1693238299956,200,162,38
78,1693238299956,1692266035886,1692266036049,1693238300266,310,163,147
79,1693238300266,1692266036193,1692266036355,1693238300479,213,162,51
80,1693238300480,1692266036399,1692266036561,1693238300692,212,162,50
81,1693238300692,1692266036633,1692266036795,1693238300919,227,162,65
82,1693238300920,1692266036847,1692266037010,1693238301137,217,163,54
83,1693238301137,1692266037071,1692266037234,1693238301358,221,163,58
84,1693238301358,1692266037283,1692266037445,1693238301570,212,162,50
85,1693238301570,1692266037511,1692266037673,1693238301797,227,162,65
86,1693238301797,1692266037716,1692266037878,1693238302002,205,162,43
87,1693238302002,1692266037891,1692266038052,1693238302178,176,161,15
88,1693238302178,1692266038102,1692266038264,1693238302390,212,162,50
89,1693238302390,1692266038314,1692266038477,1693238302601,211,163,48
90,1693238302601,1692266038519,1692266038681,1693238302805,204,162,42
91,1693238302805,1692266038721,1692266038885,1693238303009,204,164,40
92,1693238303009,1692266038938,1692266039101,1693238303225,216,163,53
93,1693238303225,1692266039152,1692266039315,1693238303439,214,163,51
94,1693238303439,1692266039389,1692266039552,1693238303678,239,163,76
95,1693238303678,1692266039632,1692266039795,1693238303919,241,163,78
96,1693238303919,1692266039865,1692266040027,1693238304151,232,162,70
97,1693238304151,1692266040086,1692266040250,1693238304374,223,164,59
98,1693238304374,1692266040322,1692266040485,1693238304610,236,163,73
99,1693238304610,1692266040536,1692266040699,1693238304823,213,163,50
100,1693238304823,1692266040745,1692266040909,1693238305035,212,164,48
101,1693238305035,1692266040968,1692266041132,1693238305257,222,164,58
102,1693238305257,1692266041187,1692266041350,1693238305474,217,163,54
103,1693238305474,1692266041383,1692266041544,1693238305668,194,161,33
104,1693238305668,1692266041586,1692266041748,1693238305872,204,162,42
105,1693238305872,1692266041793,1692266041956,1693238306080,208,163,45
106,1693238306080,1692266042005,1692266042169,1693238306293,213,164,49
107,1693238306293,1692266042220,1692266042383,1693238306506,213,163,50
108,1693238306506,1692266042436,1692266042600,1693238306725,219,164,55
109,1693238306725,1692266042631,1692266042793,1693238306920,195,162,33
110,1693238306920,1692266042835,1692266042997,1693238307121,201,162,39
111,1693238307121,1692266043067,1692266043230,1693238307354,233,163,70
112,1693238307354,1692266043273,1692266043437,1693238307569,215,164,51
113,1693238307569,1692266043528,1692266043691,1693238307817,248,163,85
114,1693238307817,1692266043757,1692266043920,1693238308045,228,163,65
115,1693238308046,1692266043971,1692266044134,1693238308258,212,163,49
116,1693238308258,1692266044194,1692266044358,1693238308482,224,164,60
117,1693238308482,1692266044416,1692266044578,1693238308702,220,162,58
118,1693238308702,1692266044604,1692266044767,1693238308891,189,163,26
119,1693238308891,1692266044802,1692266044963,1693238309087,196,161,35
120,1693238309087,1692266045036,1692266045199,1693238309324,237,163,74
121,1693238309324,1692266045269,1692266045431,1693238309557,233,162,71
122,1693238309557,1692266045485,1692266045648,1693238309771,214,163,51
123,1693238309771,1692266045705,1692266045869,1693238309993,222,164,58
124,1693238309994,1692266045929,1692266046092,1693238310216,222,163,59
125,1693238310216,1692266046178,1692266046342,1693238310468,252,164,88
126,1693238310468,1692266046393,1692266046560,1693238310685,217,167,50
127,1693238310685,1692266046619,1692266046781,1693238310905,220,162,58
128,1693238310905,1692266046856,1692266047020,1693238311144,239,164,75
129,1693238311144,1692266047061,1692266047225,1693238311349,205,164,41
130,1693238311349,1692266047271,1692266047433,1693238311557,208,162,46
131,1693238311557,1692266047488,1692266047653,1693238311781,224,165,59
132,1693238311781,1692266047719,1692266047881,1693238312007,226,162,64
133,1693238312007,1692266047934,1692266048097,1693238312221,214,163,51
134,1693238312221,1692266048171,1692266048336,1693238312462,241,165,76
135,1693238312462,1692266048394,1692266048558,1693238312683,221,164,57
136,1693238312683,1692266048625,1692266048788,1693238312914,231,163,68
137,1693238312914,1692266048868,1692266049033,1693238313157,243,165,78
138,1693238313320,1692266049221,1692266049421,1693238313548,228,200,28
139,1693238313548,1692266049479,1692266049668,1693238313792,244,189,55
140,1693238313793,1692266049702,1692266049888,1693238314014,221,186,35
141,1693238314014,1692266049942,1692266050132,1693238314257,243,190,53
142,1693238314257,1692266050181,1692266050400,1693238314525,268,219,49
143,1693238314525,1692266050441,1692266050698,1693238314823,298,257,41
144,1693238314823,1692266050766,1692266050994,1693238315193,370,228,142
145,1693238315193,1692266051102,1692266051307,1693238315433,240,205,35
146,1693238315433,1692266051342,1692266051527,1693238315651,218,185,33
147,1693238315652,1692266051564,1692266051745,1693238315870,218,181,37
148,1693238315870,1692266051776,1692266051980,1693238316220,350,204,146
149,1693238316220,1692266052125,1692266052392,1693238316521,301,267,34
150,1693238316521,1692266052432,1692266052669,1693238316793,272,237,35
151,1693238316793,1692266052700,1692266052911,1693238317149,356,211,145
152,1693238317149,1692266053053,1692266053326,1693238317510,361,273,88
153,1693238317510,1692266053418,1692266053618,1693238317743,233,200,33
154,1693238317743,1692266053648,1692266053841,1693238317965,222,193,29
155,1693238317965,1692266053896,1692266054109,1693238318233,268,213,55
156,1693238318233,1692266054164,1692266054365,1693238318490,257,201,56
157,1693238318490,1692266054396,1692266054591,1693238318716,226,195,31
158,1693238318716,1692266054661,1692266054882,1693238319006,290,221,69
159,1693238319006,1692266054922,1692266055119,1693238319243,237,197,40
160,1693238319243,1692266055168,1692266055359,1693238319494,251,191,60
161,1693238319495,1692266055415,1692266055603,1693238319727,232,188,44
162,1693238319727,1692266055648,1692266055850,1693238319974,247,202,45
163,1693238319974,1692266055886,1692266056080,1693238320206,232,194,38
164,1693238320206,1692266056108,1692266056298,1693238320422,216,190,26
165,1693238320422,1692266056342,1692266056555,1693238320679,257,213,44
166,1693238320679,1692266056596,1692266056794,1693238320919,240,198,42
167,1693238320919,1692266056847,1692266057058,1693238321234,315,211,104
168,1693238321234,1692266057180,1692266057372,1693238321496,262,192,70
169,1693238321497,1692266057392,1692266057573,1693238321698,201,181,20
170,1693238321698,1692266057616,1692266057807,1693238321932,234,191,43
171,1693238321932,1692266057842,1692266058062,1693238322188,256,220,36
172,1693238322188,1692266058109,1692266058362,1693238322487,299,253,46
173,1693238322487,1692266058409,1692266058620,1693238322745,258,211,47
174,1693238322745,1692266058663,1692266058852,1693238322976,231,189,42
175,1693238322976,1692266058894,1692266059087,1693238323211,235,193,42
176,1693238323211,1692266059127,1692266059316,1693238323440,229,189,40
177,1693238323441,1692266059351,1692266059529,1693238323653,212,178,34
178,1693238323653,1692266059583,1692266059764,1693238323888,235,181,54
179,1693238323888,1692266059806,1692266059991,1693238324116,228,185,43
180,1693238324116,1692266060038,1692266060248,1693238324372,256,210,46
181,1693238324372,1692266060315,1692266060521,1693238324645,273,206,67
182,1693238324646,1692266060553,1692266060738,1693238324863,217,185,32
183,1693238324863,1692266060778,1692266060973,1693238325097,234,195,39
184,1693238325098,1692266061025,1692266061232,1693238325432,334,207,127
185,1693238325432,1692266061345,1692266061547,1693238325741,309,202,107
186,1693238325741,1692266061654,1692266061856,1693238325981,240,202,38
187,1693238325981,1692266061901,1692266062077,1693238326201,220,176,44
188,1693238326201,1692266062108,1692266062288,1693238326412,211,180,31
189,1693238326412,1692266062346,1692266062531,1693238326657,245,185,60
190,1693238326657,1692266062577,1692266062785,1693238326909,252,208,44
191,1693238326909,1692266062832,1692266063032,1693238327156,247,200,47
192,1693238327156,1692266063072,1692266063263,1693238327387,231,191,40
193,1693238327387,1692266063318,1692266063506,1693238327630,243,188,55
194,1693238327630,1692266063544,1692266063736,1693238327860,230,192,38
195,1693238327860,1692266063778,1692266063960,1693238328085,225,182,43
196,1693238328085,1692266064011,1692266064191,1693238328315,230,180,50
197,1693238328315,1692266064256,1692266064448,1693238328573,258,192,66
198,1693238328573,1692266064504,1692266064722,1693238328846,273,218,55
199,1693238328846,1692266064760,1692266064957,1693238329082,236,197,39
200,1693238329082,1692266064971,1692266065175,1693238329529,447,204,243
201,1693238329529,1692266065457,1692266065651,1693238330049,520,194,326
202,1693238330049,1692266065967,1692266066192,1693238330568,519,225,294
203,1693238330568,1692266066505,1692266066715,1693238331096,528,210,318
204,1693238331096,1692266067006,1692266067215,1693238331429,333,209,124
205,1693238331429,1692266067350,1692266067547,1693238331671,242,197,45
206,1693238331671,1692266067603,1692266067800,1693238331977,306,197,109
207,1693238331977,1692266067915,1692266068122,1693238332246,269,207,62
208,1693238332246,1692266068362,1692266068589,1693238332713,467,227,240
209,1693238332713,1692266068901,1692266069100,1693238333224,511,199,312
210,1693238333225,1692266069119,1692266069308,1693238333527,302,189,113
211,1693238333527,1692266069467,1692266069681,1693238333806,279,214,65
212,1693238333806,1692266069953,1692266070193,1693238334333,527,240,287
213,1693238334333,1692266070492,1692266070754,1693238335098,765,262,503
214,1693238335098,1692266071115,1692266071326,1693238335622,524,211,313
215,1693238335623,1692266071594,1692266071800,1693238335924,301,206,95
216,1693238335924,1692266072079,1692266072307,1693238336432,508,228,280
217,1693238336432,1692266072589,1692266072783,1693238336907,475,194,281
218,1693238336907,1692266072831,1692266073044,1693238337195,288,213,75
219,1693238337196,1692266073135,1692266073342,1693238337478,282,207,75
220,1693238337478,1692266073501,1692266073711,1693238337835,357,210,147
221,1693238337835,1692266073757,1692266073956,1693238338193,358,199,159
222,1693238338194,1692266074104,1692266074318,1693238338477,283,214,69
223,1693238338477,1692266074404,1692266074593,1693238338718,241,189,52
224,1693238338718,1692266074630,1692266074844,1693238338968,250,214,36
225,1693238338968,1692266074871,1692266075064,1693238339189,221,193,28
226,1693238339189,1692266075108,1692266075290,1693238339414,225,182,43
227,1693238339414,1692266075321,1692266075501,1693238339625,211,180,31
228,1693238339625,1692266075552,1692266075734,1693238339857,232,182,50
229,1693238339857,1692266075824,1692266076052,1693238340176,319,228,91
230,1693238340176,1692266076078,1692266076292,1693238340416,240,214,26
231,1693238340416,1692266076422,1692266076619,1693238340745,329,197,132
232,1693238340745,1692266076678,1692266076874,1693238340998,253,196,57
233,1693238340998,1692266076931,1692266077119,1693238341242,244,188,56
234,1693238341242,1692266077184,1692266077404,1693238341546,304,220,84
235,1693238341546,1692266077510,1692266077719,1693238341845,299,209,90
236,1693238341845,1692266077764,1692266077964,1693238342088,243,200,43
237,1693238342088,1692266078019,1692266078229,1693238342353,265,210,55
238,1693238342353,1692266078412,1692266078591,1693238342715,362,179,183
239,1693238342715,1692266078632,1692266078806,1693238342930,215,174,41
240,1693238342930,1692266078887,1692266079084,1693238343207,277,197,80
241,1693238343207,1692266079144,1692266079323,1693238343446,239,179,60
242,1693238343465,1692266079458,1692266079621,1693238343744,279,163,116
243,1693238343744,1692266079653,1692266079816,1693238343940,196,163,33
244,1693238343940,1692266079887,1692266080052,1693238344176,236,165,71
245,1693238344176,1692266080096,1692266080261,1693238344385,209,165,44
246,1693238344385,1692266080300,1692266080463,1693238344586,201,163,38
247,1693238344586,1692266080534,1692266080698,1693238344822,236,164,72
248,1693238344822,1692266080769,1692266080933,1693238345056,234,164,70
249,1693238345056,1692266080963,1692266081124,1693238345248,192,161,31
250,1693238345248,1692266081164,1692266081327,1693238345450,202,163,39
251,1693238345451,1692266081397,1692266081561,1693238345685,234,164,70
252,1693238345685,1692266081597,1692266081758,1693238345882,197,161,36
253,1693238345882,1692266081798,1692266081960,1693238346084,202,162,40
254,1693238346084,1692266082000,1692266082162,1693238346286,202,162,40
255,1693238346286,1692266082226,1692266082390,1693238346513,227,164,63
256,1693238346513,1692266082417,1692266082579,1693238346703,190,162,28
257,1693238346703,1692266082616,1692266082777,1693238346901,198,161,37
258,1693238346901,1692266082806,1692266082968,1693238347093,192,162,30
259,1693238347093,1692266083028,1692266083190,1693238347314,221,162,59
260,1693238347314,1692266083266,1692266083429,1693238347552,238,163,75
261,1693238347553,1692266083536,1692266083698,1693238347822,269,162,107
262,1693238347822,1692266083798,1692266083965,1693238348089,267,167,100
263,1693238348089,1692266084009,1692266084172,1693238348295,206,163,43
264,1693238348295,1692266084273,1692266084436,1693238348559,264,163,101
265,1693238348559,1692266084502,1692266084665,1693238348788,229,163,66
266,1693238348789,1692266085220,1692266085383,1693238349837,1048,163,885
267,1693238349837,1692266085786,1692266085951,1693238350360,523,165,358
268,1693238350361,1692266086329,1692266086491,1693238350885,524,162,362
269,1693238350885,1692266086847,1692266087010,1693238351409,524,163,361
270,1693238351409,1692266087367,1692266087529,1693238351933,524,162,362
271,1693238351933,1692266087879,1692266088042,1693238352457,524,163,361
272,1693238352457,1692266088397,1692266088560,1693238352981,524,163,361
273,1693238352982,1692266088907,1692266089070,1693238353507,525,163,362
274,1693238353507,1692266089448,1692266089610,1693238354074,567,162,405
275,1693238354074,1692266090022,1692266090185,1693238354555,481,163,318
276,1693238354555,1692266090832,1692266090995,1693238355119,564,163,401
277,1693238355119,1692266091501,1692266091666,1693238356129,1010,165,845
278,1693238356129,1692266092052,1692266092217,1693238356654,525,165,360
279,1693238356654,1692266092577,1692266092738,1693238357176,522,161,361
280,1693238357176,1692266093106,1692266093267,1693238357699,523,161,362
281,1693238357699,1692266093636,1692266093798,1693238358224,525,162,363
282,1693238358224,1692266094178,1692266094342,1693238358748,524,164,360
283,1693238358748,1692266094713,1692266094877,1693238359795,1047,164,883
284,1693238359795,1692266095753,1692266095917,1693238360845,1050,164,886
285,1693238360845,1692266096762,1692266096924,1693238361373,528,162,366
286,1693238361373,1692266097310,1692266097472,1693238361895,522,162,360
287,1693238361895,1692266097858,1692266098021,1693238362418,523,163,360
288,1693238362418,1692266098371,1692266098533,1693238363771,1353,162,1191
289,1693238363771,1692266099701,1692266099864,1693238363988,217,163,54
290,1693238363988,1692266099892,1692266100054,1693238364328,340,162,178
291,1693238364328,1692266100239,1692266100400,1693238364524,196,161,35
292,1693238364524,1692266100458,1692266100620,1693238364744,220,162,58
293,1693238364744,1692266100683,1692266100846,1693238364972,228,163,65
294,1693238364972,1692266100905,1692266101068,1693238365371,399,163,236
295,1693238365371,1692266101294,1692266101457,1693238365580,209,163,46
296,1693238365580,1692266101499,1692266101661,1693238365788,208,162,46
297,1693238365788,1692266101722,1692266101885,1693238366008,220,163,57
298,1693238366008,1692266101937,1692266102101,1693238366421,413,164,249
299,1693238366421,1692266102358,1692266102522,1693238366645,224,164,60
300,1693238366645,1692266102553,1692266102714,1693238366838,193,161,32
301,1693238366838,1692266102772,1692266102935,1693238367222,384,163,221
302,1693238367222,1692266103364,1692266103525,1693238367649,427,161,266
303,1693238367649,1692266103619,1692266103785,1693238367909,260,166,94
304,1693238367909,1692266103825,1692266103987,1693238368110,201,162,39
305,1693238368110,1692266104047,1692266104209,1693238368518,408,162,246
306,1693238368518,1692266104441,1692266104603,1693238368728,210,162,48
307,1693238368728,1692266104640,1692266104801,1693238368936,208,161,47
308,1693238368936,1692266104890,1692266105053,1693238369177,241,163,78
309,1693238369177,1692266105095,1692266105257,1693238369567,390,162,228
310,1693238369567,1692266105480,1692266105642,1693238369767,200,162,38
311,1693238369767,1692266105699,1692266105864,1693238369988,221,165,56
312,1693238369988,1692266105888,1692266106049,1693238370173,185,161,24
313,1693238370173,1692266106085,1692266106249,1693238370372,199,164,35
314,1693238370372,1692266106500,1692266106661,1693238370785,413,161,252
315,1693238370786,1692266106696,1692266106857,1693238371007,221,161,60
316,1693238371007,1692266106909,1692266107070,1693238371194,187,161,26
317,1693238371194,1692266107100,1692266107261,1693238371385,191,161,30
318,1693238371385,1692266107277,1692266107439,1693238371664,279,162,117
319,1693238371664,1692266107581,1692266107744,1693238371867,203,163,40
320,1693238371868,1692266107784,1692266107945,1693238372081,213,161,52
321,1693238372081,1692266108010,1692266108173,1693238372297,216,163,53
322,1693238372297,1692266108225,1692266108387,1693238372711,414,162,252
323,1693238372711,1692266108648,1692266108812,1693238372935,224,164,60
324,1693238372935,1692266108848,1692266109010,1693238373133,198,162,36
325,1693238373133,1692266109063,1692266109226,1693238373351,218,163,55
326,1693238373351,1692266109294,1692266109457,1693238373776,425,163,262
327,1693238373950,1692266109885,1692266110171,1693238374296,346,286,60
328,1693238374296,1692266110220,1692266110414,1693238374537,241,194,47
329,1693238374537,1692266110692,1692266110877,1693238375001,464,185,279
330,1693238375001,1692266110960,1692266111164,1693238375288,287,204,83
331,1693238375288,1692266111235,1692266111424,1693238375866,578,189,389
332,1693238375866,1692266111823,1692266112045,1693238376251,385,222,163
333,1693238376251,1692266112217,1692266112434,1693238376557,306,217,89
334,1693238376558,1692266112522,1692266112749,1693238376909,351,227,124
335,1693238376909,1692266112838,1692266113031,1693238377163,254,193,61
336,1693238377163,1692266113205,1692266113407,1693238377535,372,202,170
337,1693238377535,1692266113507,1692266113710,1693238377955,420,203,217
338,1693238377955,1692266113939,1692266114143,1693238378348,393,204,189
339,1693238378348,1692266114292,1692266114486,1693238378610,262,194,68
340,1693238378610,1692266114635,1692266114846,1693238379004,394,211,183
341,1693238379004,1692266114915,1692266115130,1693238379255,251,215,36
342,1693238379255,1692266115189,1692266115410,1693238379536,281,221,60
343,1693238379536,1692266115452,1692266115668,1693238379792,256,216,40
344,1693238379792,1692266115957,1692266116143,1693238380283,491,186,305
345,1693238380283,1692266116191,1692266116384,1693238380508,225,193,32
346,1693238380508,1692266116427,1692266116622,1693238380746,238,195,43
347,1693238380746,1692266116686,1692266116869,1693238381101,355,183,172
348,1693238381101,1692266117002,1692266117196,1693238381322,221,194,27
349,1693238381322,1692266117242,1692266117463,1693238381587,265,221,44
350,1693238381587,1692266117493,1692266117688,1693238381811,224,195,29
351,1693238381811,1692266117742,1692266117972,1693238382149,338,230,108
352,1693238382149,1692266118109,1692266118305,1693238382429,280,196,84
353,1693238382429,1692266118445,1692266118699,1693238382824,395,254,141
354,1693238382824,1692266118739,1692266118986,1693238383200,376,247,129
355,1693238383200,1692266119126,1692266119359,1693238383483,283,233,50
356,1693238383483,1692266119487,1692266119708,1693238383832,349,221,128
357,1693238383832,1692266119786,1692266120004,1693238384249,417,218,199
358,1693238384249,1692266120218,1692266120410,1693238384533,284,192,92
359,1693238384534,1692266120450,1692266120640,1693238384764,230,190,40
360,1693238384764,1692266120725,1692266120922,1693238385046,282,197,85
361,1693238385046,1692266120957,1692266121185,1693238385309,263,228,35
362,1693238385309,1692266121270,1692266121484,1693238385687,378,214,164
363,1693238385687,1692266121626,1692266121816,1693238385940,253,190,63
364,1693238385940,1692266121859,1692266122039,1693238386344,404,180,224
365,1693238386344,1692266122286,1692266122493,1693238386616,272,207,65
366,1693238386616,1692266122530,1692266122727,1693238386851,235,197,38
367,1693238386851,1692266122794,1692266122976,1693238387099,248,182,66
368,1693238387099,1692266123020,1692266123210,1693238387395,296,190,106
369,1693238387395,1692266123322,1692266123544,1693238387671,276,222,54
370,1693238387671,1692266123673,1692266123916,1693238388040,369,243,126
371,1693238388040,1692266123973,1692266124187,1693238388443,403,214,189
372,1693238388443,1692266124384,1692266124600,1693238388724,281,216,65
373,1693238388724,1692266124637,1692266124852,1693238388976,252,215,37
374,1693238388976,1692266124892,1692266125072,1693238389195,219,180,39
375,1693238389195,1692266125125,1692266125325,1693238389491,296,200,96
376,1693238389491,1692266125462,1692266125658,1693238389794,303,196,107
377,1693238389794,1692266125830,1692266126028,1693238390152,358,198,160
378,1693238390152,1692266126085,1692266126285,1693238390538,386,200,186
379,1693238390538,1692266126487,1692266126672,1693238390796,258,185,73
380,1693238390796,1692266126826,1692266127021,1693238391144,348,195,153
381,1693238391144,1692266127059,1692266127246,1693238391595,451,187,264
382,1693238391595,1692266127521,1692266127725,1693238391849,254,204,50
383,1693238391849,1692266127764,1692266127986,1693238392109,260,222,38
384,1693238392109,1692266128038,1692266128235,1693238392358,249,197,52
385,1693238392358,1692266128300,1692266128532,1693238392657,299,232,67
386,1693238392657,1692266128606,1692266128843,1693238393025,368,237,131
387,1693238393025,1692266128979,1692266129216,1693238393340,315,237,78
388,1693238393340,1692266129254,1692266129470,1693238393684,344,216,128
389,1693238393684,1692266129595,1692266129821,1693238393944,260,226,34
390,1693238393944,1692266129866,1692266130076,1693238394200,256,210,46
391,1693238394200,1692266130124,1692266130318,1693238394442,242,194,48
392,1693238394442,1692266130341,1692266130560,1693238394935,493,219,274
393,1693238394935,1692266130863,1692266131081,1693238395205,270,218,52
394,1693238395205,1692266131110,1692266131325,1693238395449,244,215,29
395,1693238395449,1692266131366,1692266131618,1693238395780,331,252,79
396,1693238395780,1692266131705,1692266131958,1693238396083,303,253,50
397,1693238396083,1692266132095,1692266132291,1693238396496,413,196,217
398,1693238396496,1692266132420,1692266132622,1693238396828,332,202,130
399,1693238396828,1692266132764,1692266133021,1693238397352,524,257,267
400,1693238397353,1692266133263,1692266133455,1693238397578,225,192,33
401,1693238397578,1692266133515,1692266133734,1693238397879,301,219,82
402,1693238397879,1692266133790,1692266134044,1693238398168,289,254,35
403,1693238398168,1692266134089,1692266134333,1693238398457,289,244,45
404,1693238398457,1692266134392,1692266134596,1693238398925,468,204,264
405,1693238398925,1692266134860,1692266135095,1693238399218,293,235,58
406,1693238399218,1692266135336,1692266135558,1693238399683,465,222,243
407,1693238399683,1692266135612,1692266135807,1693238399977,294,195,99
408,1693238399977,1692266135890,1692266136096,1693238400220,243,206,37
409,1693238400220,1692266136161,1692266136352,1693238400504,284,191,93
410,1693238400504,1692266136427,1692266136604,1693238400727,223,177,46
411,1693238400727,1692266136663,1692266136847,1693238401025,298,184,114
412,1693238401025,1692266136968,1692266137166,1693238401290,265,198,67
413,1693238401290,1692266137199,1692266137412,1693238401548,258,213,45
414,1693238401548,1692266137457,1692266137641,1693238401765,217,184,33
415,1693238401765,1692266137708,1692266137913,1693238402071,306,205,101
416,1693238402071,1692266137998,1692266138192,1693238402316,245,194,51
417,1693238402316,1692266138232,1692266138442,1693238402565,249,210,39
418,1693238402565,1692266138487,1692266138703,1693238402827,262,216,46
419,1693238402827,1692266138746,1692266138950,1693238403119,292,204,88
420,1693238403120,1692266139037,1692266139242,1693238403366,246,205,41
421,1693238403366,1692266139278,1692266139465,1693238403597,231,187,44
422,1693238403597,1692266139505,1692266139681,1693238403804,207,176,31
423,1693238403804,1692266139735,1692266139907,1693238404169,365,172,193
424,1693238404180,1692266140114,1692266140277,1693238404403,223,163,60
425,1693238404403,1692266140332,1692266140494,1693238404617,214,162,52
426,1693238404617,1692266140521,1692266140683,1693238404806,189,162,27
427,1693238404806,1692266140706,1692266140869,1693238404992,186,163,23
428,1693238404992,1692266141119,1692266141281,1693238405405,413,162,251
429,1693238405405,1692266141320,1692266141482,1693238405608,203,162,41
430,1693238405608,1692266141564,1692266141726,1693238405849,241,162,79
431,1693238405849,1692266141739,1692266141900,1693238406023,174,161,13
432,1693238406024,1692266142170,1692266142333,1693238406456,432,163,269
433,1693238406456,1692266142370,1692266142532,1693238406659,203,162,41
434,1693238406659,1692266142595,1692266142758,1693238406881,222,163,59
435,1693238406881,1692266142814,1692266142977,1693238407316,435,163,272
436,1693238407316,1692266143251,1692266143414,1693238407543,227,163,64
437,1693238407543,1692266143464,1692266143627,1693238407750,207,163,44
438,1693238407750,1692266143671,1692266143833,1693238407956,206,162,44
439,1693238407956,1692266143900,1692266144064,1693238408362,406,164,242
440,1693238408362,1692266144287,1692266144449,1693238408573,211,162,49
441,1693238408573,1692266144484,1692266144645,1693238408782,209,161,48
442,1693238408782,1692266144708,1692266144872,1693238408998,216,164,52
443,1693238408998,1692266144931,1692266145095,1693238409413,415,164,251
444,1693238409413,1692266145328,1692266145491,1693238409614,201,163,38
445,1693238409614,1692266145526,1692266145687,1693238409810,196,161,35
446,1693238409810,1692266145717,1692266145878,1693238410017,207,161,46
447,1693238410017,1692266145935,1692266146098,1693238410221,204,163,41
448,1693238410222,1692266146346,1692266146509,1693238410632,410,163,247
449,1693238410632,1692266146558,1692266146723,1693238410853,221,165,56
450,1693238410854,1692266146760,1692266146921,1693238411045,191,161,30
451,1693238411045,1692266146958,1692266147119,1693238411242,197,161,36
452,1693238411242,1692266147167,1692266147329,1693238411508,266,162,104
453,1693238411508,1692266147446,1692266147609,1693238411734,226,163,63
454,1693238411734,1692266147656,1692266147818,1693238411940,206,162,44
455,1693238411940,1692266147892,1692266148055,1693238412179,239,163,76
456,1693238412179,1692266148092,1692266148254,1693238412557,378,162,216
457,1693238412557,1692266148491,1692266148653,1693238412776,219,162,57
458,1693238412776,1692266148713,1692266148876,1693238412999,223,163,60
459,1693238412999,1692266148913,1692266149074,1693238413197,198,161,37
460,1693238413197,1692266149107,1692266149270,1693238413608,411,163,248
461,1693238413608,1692266149561,1692266149724,1693238413847,239,163,76
462,1693238413847,1692266149772,1692266149934,1693238414057,210,162,48
463,1693238414057,1692266149977,1692266150140,1693238414285,228,163,65
464,1693238414285,1692266150207,1692266150371,1693238414661,376,164,212
465,1693238414661,1692266150634,1692266150798,1693238414921,260,164,96
466,1693238414921,1692266151074,1692266151237,1693238415371,450,163,287
467,1693238415371,1692266151788,1692266151951,1693238416098,727,163,564
468,1693238416098,1692266152033,1692266152197,1693238416319,221,164,57
469,1693238416320,1692266152247,1692266152409,1693238416756,436,162,274
470,1693238416756,1692266152669,1692266152831,1693238416953,197,162,35
471,1693238416953,1692266152888,1692266153050,1693238417173,220,162,58
472,1693238417173,1692266153070,1692266153233,1693238417356,183,163,20
473,1693238417356,1692266153279,1692266153442,1693238417565,209,163,46
474,1693238417565,1692266153682,1692266153844,1693238417967,402,162,240
475,1693238417967,1692266153902,1692266154064,1693238418191,224,162,62
476,1693238418191,1692266154132,1692266154294,1693238418417,226,162,64
477,1693238418417,1692266154337,1692266154499,1693238418622,205,162,43
478,1693238418623,1692266154757,1692266154918,1693238419041,418,161,257
479,1693238419041,1692266154964,1692266155126,1693238419249,208,162,46
480,1693238419249,1692266155187,1692266155351,1693238419661,412,164,248
481,1693238419661,1692266155786,1692266155948,1693238420071,410,162,248
482,1693238420071,1692266156047,1692266156211,1693238420335,264,164,100
483,1693238420336,1692266156266,1692266156430,1693238420553,217,164,53
484,1693238420553,1692266156506,1692266156672,1693238420946,393,166,227
485,1693238420946,1692266156861,1692266157022,1693238421146,200,161,39
486,1693238421146,1692266157065,1692266157229,1693238421364,218,164,54
487,1693238421364,1692266157294,1692266157459,1693238421582,218,165,53
488,1693238421582,1692266157504,1692266157667,1693238421993,411,163,248
489,1693238421993,1692266157923,1692266158088,1693238422211,218,165,53
490,1693238422211,1692266158146,1692266158309,1693238422433,222,163,59
491,1693238422433,1692266158384,1692266158546,1693238422669,236,162,74
492,1693238422670,1692266158597,1692266158759,1693238423046,376,162,214
493,1693238423046,1692266159002,1692266159166,1693238423289,243,164,79
494,1693238423289,1692266159214,1692266159377,1693238423500,211,163,48
495,1693238423500,1692266159413,1692266159574,1693238423697,197,161,36
496,1693238423697,1692266159620,1692266159782,1693238424091,394,162,232
497,1693238424091,1692266160026,1692266160192,1693238424315,224,166,58
498,1693238424315,1692266160254,1692266160419,1693238424542,227,165,62
499,1693238424543,1692266160477,1692266160640,1693238424763,220,163,57
500,1693238424763,1692266160685,1692266160850,1693238425139,376,165,211
501,1693238425139,1692266161091,1692266161257,1693238425380,241,166,75
502,1693238425380,1692266161294,1692266161456,1693238425580,200,162,38
503,1693238425580,1692266161541,1692266161706,1693238425830,250,165,85
504,1693238425830,1692266161767,1692266161931,1693238426192,362,164,198
505,1693238426192,1692266162098,1692266162261,1693238426384,192,163,29
506,1693238426384,1692266162338,1692266162503,1693238426626,242,165,77
507,1693238426626,1692266162542,1692266162704,1693238426827,201,162,39
508,1693238426827,1692266162737,1692266162899,1693238427241,414,162,252
509,1693238427241,1692266163160,1692266163323,1693238427446,205,163,42
510,1693238427446,1692266163347,1692266163509,1693238427631,185,162,23
511,1693238427631,1692266163570,1692266163733,1693238427855,224,163,61
512,1693238427855,1692266163771,1692266163933,1693238428056,201,162,39
513,1693238428056,1692266164182,1692266164344,1693238428467,411,162,249
514,1693238428467,1692266164382,1692266164543,1693238428679,212,161,51
515,1693238428679,1692266164590,1692266164751,1693238428891,212,161,51
516,1693238428891,1692266164826,1692266164990,1693238429112,221,164,57
517,1693238429112,1692266165248,1692266165410,1693238429533,421,162,259
518,1693238429533,1692266165487,1692266165652,1693238429775,242,165,77
519,1693238429775,1692266165693,1692266165855,1693238429978,203,162,41
520,1693238429978,1692266165941,1692266166104,1693238430383,405,163,242
521,1693238430383,1692266166293,1692266166455,1693238430578,195,162,33
522,1693238430578,1692266166514,1692266166679,1693238430802,224,165,59
523,1693238430802,1692266166717,1692266166879,1693238431003,201,162,39
524,1693238431003,1692266166931,1692266167094,1693238431431,428,163,265
525,1693238431431,1692266167355,1692266167517,1693238431640,209,162,47
526,1693238431640,1692266167543,1692266167705,1693238431828,188,162,26
527,1693238431828,1692266167730,1692266167892,1693238432035,207,162,45
528,1693238432035,1692266167991,1692266168155,1693238432480,445,164,281
529,1693238432480,1692266168386,1692266168548,1693238432671,191,162,29
530,1693238432671,1692266168636,1692266168801,1693238432924,253,165,88
531,1693238432924,1692266168855,1692266169018,1693238433158,234,163,71
532,1693238433159,1692266169096,1692266169260,1693238433528,369,164,205
533,1693238433528,1692266169447,1692266169609,1693238433732,204,162,42
534,1693238433732,1692266169659,1692266169821,1693238433944,212,162,50
535,1693238433944,1692266169871,1692266170033,1693238434155,211,162,49
536,1693238434156,1692266170072,1692266170234,1693238434576,420,162,258
537,1693238434739,1692266170647,1692266170921,1693238435044,305,274,31
538,1693238435044,1692266170997,1692266171225,1693238435348,304,228,76
539,1693238435348,1692266171279,1692266171471,1693238435629,281,192,89
540,1693238435629,1692266171549,1692266171737,1693238435860,231,188,43
541,1693238435860,1692266171795,1692266172000,1693238436123,263,205,58
542,1693238436123,1692266172034,1692266172240,1693238436363,240,206,34
543,1693238436363,1692266172305,1692266172489,1693238436674,311,184,127
544,1693238436675,1692266172579,1692266172759,1693238436882,207,180,27
545,1693238436882,1692266172789,1692266172982,1693238437105,223,193,30
546,1693238437105,1692266173012,1692266173222,1693238437399,294,210,84
547,1693238437399,1692266173328,1692266173524,1693238437723,324,196,128
548,1693238437723,1692266173671,1692266173874,1693238437997,274,203,71
549,1693238437997,1692266173895,1692266174079,1693238438215,218,184,34
550,1693238438215,1692266174127,1692266174301,1693238438424,209,174,35
551,1693238438424,1692266174340,1692266174516,1693238438772,348,176,172
552,1693238438772,1692266174683,1692266174874,1693238439003,231,191,40
553,1693238439003,1692266174926,1692266175127,1693238439251,248,201,47
554,1693238439251,1692266175205,1692266175420,1693238439544,293,215,78
555,1693238439544,1692266175456,1692266175688,1693238439819,275,232,43
556,1693238439819,1692266175734,1692266175929,1693238440052,233,195,38
557,1693238440052,1692266176142,1692266176348,1693238440472,420,206,214
558,1693238440472,1692266176392,1692266176573,1693238440868,396,181,215
559,1693238440869,1692266176810,1692266177014,1693238441141,272,204,68
560,1693238441141,1692266177160,1692266177426,1693238441550,409,266,143
561,1693238441550,1692266177485,1692266177721,1693238441928,378,236,142
562,1693238441928,1692266177835,1692266178028,1693238442150,222,193,29
563,1693238442150,1692266178100,1692266178291,1693238442413,263,191,72
564,1693238442413,1692266178329,1692266178538,1693238442662,249,209,40
565,1693238442662,1692266178577,1692266178774,1693238442897,235,197,38
566,1693238442897,1692266178812,1692266179040,1693238443163,266,228,38
567,1693238443164,1692266179086,1692266179314,1693238443497,333,228,105
568,1693238443497,1692266179422,1692266179628,1693238443752,255,206,49
569,1693238443752,1692266179691,1692266179882,1693238444006,254,191,63
570,1693238444006,1692266179982,1692266180198,1693238444321,315,216,99
571,1693238444322,1692266180233,1692266180430,1693238444553,231,197,34
572,1693238444554,1692266180492,1692266180693,1693238444816,262,201,61
573,1693238444817,1692266180739,1692266180942,1693238445066,249,203,46
574,1693238445066,1692266180983,1692266181171,1693238445294,228,188,40
575,1693238445294,1692266181229,1692266181419,1693238445543,249,190,59
576,1693238445543,1692266181459,1692266181717,1693238445840,297,258,39
577,1693238445840,1692266181771,1692266182032,1693238446202,362,261,101
578,1693238446202,1692266182119,1692266182340,1693238446569,367,221,146
579,1693238446569,1692266182487,1692266182694,1693238446877,308,207,101
580,1693238446877,1692266182807,1692266183020,1693238447181,304,213,91
581,1693238447181,1692266183109,1692266183362,1693238447496,315,253,62
582,1693238447496,1692266183409,1692266183650,1693238447773,277,241,36
583,1693238447773,1692266183718,1692266183944,1693238448089,316,226,90
584,1693238448089,1692266184006,1692266184238,1693238448412,323,232,91
585,1693238448412,1692266184326,1692266184580,1693238448720,308,254,54
586,1693238448720,1692266184660,1692266184896,1693238449019,299,236,63
587,1693238449019,1692266184936,1692266185142,1693238449266,247,206,41
588,1693238449266,1692266185179,1692266185411,1693238449535,269,232,37
589,1693238449535,1692266185452,1692266185698,1693238449821,286,246,40
590,1693238449821,1692266185738,1692266185967,1693238450090,269,229,40
591,1693238450090,1692266186014,1692266186238,1693238450386,296,224,72
592,1693238450386,1692266186292,1692266186506,1693238450630,244,214,30
593,1693238450630,1692266186545,1692266186778,1693238450901,271,233,38
594,1693238450901,1692266186827,1692266187061,1693238451184,283,234,49
595,1693238451184,1692266187127,1692266187357,1693238451480,296,230,66
596,1693238451480,1692266187394,1692266187627,1693238451750,270,233,37
597,1693238451751,1692266187666,1692266187864,1693238451987,236,198,38
598,1693238451987,1692266187915,1692266188116,1693238452239,252,201,51
599,1693238452239,1692266188161,1692266188378,1693238452504,265,217,48
600,1693238452504,1692266188424,1692266188661,1693238452784,280,237,43
601,1693238452784,1692266188723,1692266188955,1693238453077,293,232,61
602,1693238453078,1692266189024,1692266189227,1693238453351,273,203,70
603,1693238453351,1692266189277,1692266189511,1693238453634,283,234,49
604,1693238453634,1692266189566,1692266189800,1693238453926,292,234,58
605,1693238453926,1692266189832,1692266190045,1693238454169,243,213,30
606,1693238454169,1692266190080,1692266190275,1693238454421,252,195,57
607,1693238454421,1692266190335,1692266190539,1693238454662,241,204,37
608,1693238454662,1692266190660,1692266190884,1693238455007,345,224,121
609,1693238455007,1692266190937,1692266191160,1693238455282,275,223,52
610,1693238455282,1692266191237,1692266191455,1693238455579,297,218,79
611,1693238455579,1692266191496,1692266191747,1693238455870,291,251,40
612,1693238455870,1692266191795,1692266192023,1693238456146,276,228,48
613,1693238456146,1692266192058,1692266192257,1693238456382,236,199,37
614,1693238456382,1692266192294,1692266192522,1693238456645,263,228,35
615,1693238456645,1692266192567,1692266192786,1693238457054,409,219,190
616,1693238457054,1692266192951,1692266193157,1693238457580,526,206,320
617,1693238457580,1692266193502,1692266193701,1693238458102,522,199,323
618,1693238458102,1692266194045,1692266194275,1693238458626,524,230,294
619,1693238458626,1692266194555,1692266194797,1693238459151,525,242,283
620,1693238459151,1692266195093,1692266195307,1693238459676,525,214,311
621,1693238459676,1692266195639,1692266195902,1693238460199,523,263,260
622,1693238460199,1692266196147,1692266196334,1693238460724,525,187,338
623,1693238460724,1692266196659,1692266196909,1693238461247,523,250,273
624,1693238461247,1692266197180,1692266197434,1693238461711,464,254,210
625,1693238461711,1692266197655,1692266197952,1693238462077,366,297,69
626,1693238462077,1692266198019,1692266198215,1693238462338,261,196,65
627,1693238462338,1692266198239,1692266198443,1693238462627,289,204,85
628,1693238462627,1692266198542,1692266198748,1693238462870,243,206,37
629,1693238462871,1692266198796,1692266198991,1693238463113,242,195,47
630,1693238463113,1692266199029,1692266199230,1693238463353,240,201,39
631,1693238463353,1692266199268,1692266199464,1693238463677,324,196,128
632,1693238463677,1692266199602,1692266199782,1693238463904,227,180,47
633,1693238463904,1692266199822,1692266200001,1693238464124,220,179,41
634,1693238464124,1692266200056,1692266200239,1693238464361,237,183,54
635,1693238464362,1692266200274,1692266200474,1693238464727,365,200,165
636,1693238464728,1692266200671,1692266200834,1693238464956,228,163,65
637,1693238464964,1692266200883,1692266201045,1693238465168,204,162,42
638,1693238465168,1692266201124,1692266201288,1693238465410,242,164,78
639,1693238465411,1692266201316,1692266201478,1693238465775,364,162,202
640,1693238465775,1692266201706,1692266201868,1693238466005,230,162,68
641,1693238466005,1692266201940,1692266202103,1693238466231,226,163,63
642,1693238466231,1692266202147,1692266202310,1693238466454,223,163,60
643,1693238466454,1692266202380,1692266202542,1693238466824,370,162,208
644,1693238466824,1692266202732,1692266202893,1693238467016,192,161,31
645,1693238467016,1692266202945,1692266203108,1693238467237,221,163,58
646,1693238467238,1692266203149,1692266203311,1693238467434,196,162,34
647,1693238467434,1692266203338,1692266203499,1693238467622,188,161,27
648,1693238467622,1692266203755,1692266203918,1693238468043,421,163,258
649,1693238468043,1692266203969,1692266204132,1693238468264,221,163,58
650,1693238468264,1692266204178,1692266204340,1693238468479,215,162,53
651,1693238468479,1692266204403,1692266204566,1693238468688,209,163,46
652,1693238468688,1692266204818,1692266204980,1693238469102,414,162,252
653,1693238469102,1692266205033,1692266205194,1693238469317,215,161,54
654,1693238469317,1692266205240,1692266205402,1693238469524,207,162,45
655,1693238469524,1692266205454,1692266205617,1693238469739,215,163,52
656,1693238469739,1692266205870,1692266206032,1693238470154,415,162,253
657,1693238470154,1692266206096,1692266206260,1693238470383,229,164,65
658,1693238470383,1692266206284,1692266206445,1693238470572,189,161,28
659,1693238470572,1692266206490,1692266206653,1693238470795,223,163,60
660,1693238470795,1692266206943,1692266207107,1693238471246,451,164,287
661,1693238471246,1692266207149,1692266207313,1693238471435,189,164,25
662,1693238471435,1692266207353,1692266207515,1693238471637,202,162,40
663,1693238471637,1692266207586,1692266207749,1693238472064,427,163,264
664,1693238472064,1692266207970,1692266208133,1693238472255,191,163,28
665,1693238472255,1692266208197,1692266208360,1693238472483,228,163,65
666,1693238472484,1692266208387,1692266208550,1693238472673,189,163,26
667,1693238472673,1692266208594,1692266208758,1693238472884,211,164,47
668,1693238472884,1692266209031,1692266209194,1693238473316,432,163,269
669,1693238473316,1692266209265,1692266209429,1693238473552,236,164,72
670,1693238473552,1692266209469,1692266209631,1693238473753,201,162,39
671,1693238473753,1692266209664,1692266209829,1693238474164,411,165,246
672,1693238474164,1692266210116,1692266210279,1693238474422,258,163,95
673,1693238474422,1692266210459,1692266210621,1693238474743,321,162,159
674,1693238474743,1692266210675,1692266210837,1693238474960,217,162,55
675,1693238474960,1692266210883,1692266211045,1693238475211,251,162,89
676,1693238475211,1692266211134,1692266211296,1693238475419,208,162,46
677,1693238475419,1692266211346,1692266211509,1693238475631,212,163,49
678,1693238475631,1692266211561,1692266211725,1693238475853,222,164,58
679,1693238475853,1692266211769,1692266211931,1693238476260,407,162,245
680,1693238476261,1692266212199,1692266212363,1693238476485,224,164,60
681,1693238476485,1692266212407,1692266212571,1693238476693,208,164,44
682,1693238476693,1692266212612,1692266212775,1693238476897,204,163,41
683,1693238476898,1692266212808,1692266212969,1693238477309,411,161,250
684,1693238477309,1692266213225,1692266213388,1693238477510,201,163,38
685,1693238477510,1692266213449,1692266213612,1693238477734,224,163,61
686,1693238477734,1692266213665,1692266213829,1693238477951,217,164,53
687,1693238477951,1692266213891,1692266214054,1693238478356,405,163,242
688,1693238478356,1692266214270,1692266214433,1693238478556,200,163,37
689,1693238478556,1692266214466,1692266214629,1693238478772,216,163,53
690,1693238478772,1692266214691,1692266214853,1693238478976,204,162,42
691,1693238478976,1692266214894,1692266215056,1693238479178,202,162,40
692,1693238479178,1692266215452,1692266215614,1693238479798,620,162,458
693,1693238479798,1692266215734,1692266215896,1693238480019,221,162,59
694,1693238480019,1692266215951,1692266216115,1693238480455,436,164,272
695,1693238480455,1692266216364,1692266216526,1693238480648,193,162,31
696,1693238480648,1692266216594,1692266216756,1693238480879,231,162,69
697,1693238480879,1692266216805,1692266216968,1693238481090,211,163,48
698,1693238481090,1692266217026,1692266217188,1693238481504,414,162,252
699,1693238481504,1692266217438,1692266217601,1693238481723,219,163,56
700,1693238481723,1692266217653,1692266217816,1693238481938,215,163,52
701,1693238481938,1692266217872,1692266218036,1693238482159,221,164,57
702,1693238482159,1692266218106,1692266218270,1693238482550,391,164,227
703,1693238482550,1692266218459,1692266218621,1693238482743,193,162,31
704,1693238482743,1692266218653,1692266218815,1693238482943,200,162,38
705,1693238482943,1692266218867,1692266219031,1693238483155,212,164,48
706,1693238483155,1692266219107,1692266219271,1693238483601,446,164,282
707,1693238483601,1692266219547,1692266219710,1693238483833,232,163,69
708,1693238483833,1692266219755,1692266219917,1693238484039,206,162,44
709,1693238484039,1692266219947,1692266220109,1693238484232,193,162,31
710,1693238484232,1692266220185,1692266220347,1693238484647,415,162,253
711,1693238484647,1692266220571,1692266220733,1693238484856,209,162,47
712,1693238484856,1692266220765,1692266220928,1693238485063,207,163,44
713,1693238485063,1692266220978,1692266221141,1693238485263,200,163,37
714,1693238485263,1692266221219,1692266221383,1693238485697,434,164,270
715,1693238485697,1692266221662,1692266221826,1693238485948,251,164,87
716,1693238485948,1692266221877,1692266222039,1693238486161,213,162,51
717,1693238486161,1692266222097,1692266222261,1693238486383,222,164,58
718,1693238486383,1692266222311,1692266222474,1693238486937,554,163,391
719,1693238486937,1692266222863,1692266223026,1693238487312,375,163,212
720,1693238487312,1692266223232,1692266223400,1693238487525,213,168,45
721,1693238487525,1692266223695,1692266223859,1693238487982,457,164,293
722,1693238487982,1692266223895,1692266224056,1693238488318,336,161,175
723,1693238488318,1692266224251,1692266224413,1693238488543,225,162,63
724,1693238488543,1692266224486,1692266224648,1693238488842,299,162,137
725,1693238488842,1692266224809,1692266224971,1693238489093,251,162,89
726,1693238489093,1692266225261,1692266225425,1693238489548,455,164,291
727,1693238489548,1692266225490,1692266225652,1693238489890,342,162,180
728,1693238489890,1692266225825,1692266225988,1693238490116,226,163,63
729,1693238490116,1692266226031,1692266226192,1693238490414,298,161,137
730,1693238490414,1692266226437,1692266226600,1693238490939,525,163,362
731,1693238490939,1692266226858,1692266227021,1693238491143,204,163,41
732,1693238491143,1692266227062,1692266227224,1693238491466,323,162,161
733,1693238491466,1692266227396,1692266227559,1693238491694,228,163,65
734,1693238491694,1692266227625,1692266227787,1693238491988,294,162,132
735,1693238491988,1692266227929,1692266228092,1693238492214,226,163,63
736,1693238492214,1692266228137,1692266228301,1693238492511,297,164,133
737,1693238492511,1692266228422,1692266228584,1693238492706,195,162,33
738,1693238492706,1692266228614,1692266228776,1693238493039,333,162,171
739,1693238493040,1692266228972,1692266229135,1693238493265,225,163,62
740,1693238493266,1692266229187,1692266229349,1693238493471,205,162,43
741,1693238493471,1692266229413,1692266229576,1693238493716,245,163,82
742,1693238493716,1692266229661,1692266229824,1693238494084,368,163,205
743,1693238494084,1692266230015,1692266230177,1693238494299,215,162,53
744,1693238494299,1692266230231,1692266230394,1693238494516,217,163,54
745,1693238494516,1692266230441,1692266230605,1693238494727,211,164,47
746,1693238494727,1692266230649,1692266230810,1693238495133,406,161,245
747,1693238495297,1692266231249,1692266231496,1693238495627,330,247,83
748,1693238495627,1692266231560,1692266231756,1693238495879,252,196,56
749,1693238495879,1692266231803,1692266232010,1693238496181,302,207,95
750,1693238496181,1692266232113,1692266232294,1693238496418,237,181,56
751,1693238496418,1692266232362,1692266232559,1693238496681,263,197,66
752,1693238496681,1692266232636,1692266232848,1693238496970,289,212,77
753,1693238496970,1692266232904,1692266233092,1693238497231,261,188,73
754,1693238497232,1692266233139,1692266233333,1693238497457,225,194,31
755,1693238497457,1692266233382,1692266233587,1693238497710,253,205,48
756,1693238497710,1692266233659,1692266233861,1693238497986,276,202,74
757,1693238497986,1692266233929,1692266234133,1693238498278,292,204,88
758,1693238498278,1692266234213,1692266234403,1693238498525,247,190,57
759,1693238498525,1692266234580,1692266234798,1693238498922,397,218,179
760,1693238498922,1692266234847,1692266235083,1693238499330,408,236,172
761,1693238499330,1692266235253,1692266235458,1693238499581,251,205,46
762,1693238499581,1692266235528,1692266235719,1693238499842,261,191,70
763,1693238499842,1692266235781,1692266235961,1693238500083,241,180,61
764,1693238500083,1692266235990,1692266236170,1693238500375,292,180,112
765,1693238500375,1692266236307,1692266236499,1693238500621,246,192,54
766,1693238500621,1692266236701,1692266236920,1693238501054,433,219,214
767,1693238501054,1692266237065,1692266237287,1693238501424,370,222,148
768,1693238501424,1692266237374,1692266237591,1693238501713,289,217,72
769,1693238501713,1692266237711,1692266237931,1693238502057,344,220,124
770,1693238502057,1692266238006,1692266238208,1693238502472,415,202,213
771,1693238502472,1692266238403,1692266238617,1693238502739,267,214,53
772,1693238502739,1692266238674,1692266238875,1693238502998,259,201,58
773,1693238502998,1692266238914,1692266239129,1693238503253,255,215,40
774,1693238503253,1692266239172,1692266239375,1693238503521,268,203,65
775,1693238503521,1692266239453,1692266239652,1693238503775,254,199,55
776,1693238503775,1692266239713,1692266239926,1693238504048,273,213,60
777,1693238504048,1692266239983,1692266240176,1693238504299,251,193,58
778,1693238504300,1692266240208,1692266240423,1693238504569,269,215,54
779,1693238504570,1692266240480,1692266240715,1693238504839,269,235,34
780,1693238504839,1692266240874,1692266241088,1693238505210,371,214,157
781,1693238505210,1692266241150,1692266241345,1693238505620,410,195,215
782,1693238505620,1692266241547,1692266241743,1693238505865,245,196,49
783,1693238505865,1692266241807,1692266241999,1693238506121,256,192,64
784,1693238506121,1692266242028,1692266242218,1693238506341,220,190,30
785,1693238506341,1692266242264,1692266242477,1693238506668,327,213,114
786,1693238506668,1692266242599,1692266242787,1693238506910,242,188,54
787,1693238506910,1692266242842,1692266243053,1693238507176,266,211,55
788,1693238507176,1692266243097,1692266243296,1693238507420,244,199,45
789,1693238507420,1692266243342,1692266243542,1693238507716,296,200,96
790,1693238507716,1692266243649,1692266243904,1693238508109,393,255,138
791,1693238508109,1692266244028,1692266244255,1693238508377,268,227,41
792,1693238508377,1692266244291,1692266244490,1693238508765,388,199,189
793,1693238508765,1692266244696,1692266244934,1693238509057,292,238,54
794,1693238509057,1692266245084,1692266245328,1693238509464,407,244,163
795,1693238509465,1692266245475,1692266245739,1693238509862,397,264,133
796,1693238509862,1692266245808,1692266246056,1693238510203,341,248,93
797,1693238510203,1692266246189,1692266246420,1693238510543,340,231,109
798,1693238510543,1692266246492,1692266246724,1693238510861,318,232,86
799,1693238510861,1692266246780,1692266247023,1693238511146,285,243,42
800,1693238511146,1692266247150,1692266247404,1693238511529,383,254,129
801,1693238511529,1692266247462,1692266247725,1693238511911,382,263,119
802,1693238511911,1692266247852,1692266248068,1693238512191,280,216,64
803,1693238512191,1692266248193,1692266248401,1693238512523,332,208,124
804,1693238512523,1692266248459,1692266248657,1693238512963,440,198,242
805,1693238512963,1692266248893,1692266249095,1693238513218,255,202,53
806,1693238513218,1692266249142,1692266249364,1693238513487,269,222,47
807,1693238513487,1692266249430,1692266249656,1693238513779,292,226,66
808,1693238513779,1692266249940,1692266250122,1693238514244,465,182,283
809,1693238514244,1692266250196,1692266250404,1693238514526,282,208,74
810,1693238514527,1692266250480,1692266250684,1693238514806,279,204,75
811,1693238514806,1692266250962,1692266251182,1693238515305,499,220,279
812,1693238515305,1692266251221,1692266251466,1693238515589,284,245,39
813,1693238515589,1692266251531,1692266251758,1693238515881,292,227,65
814,1693238515881,1692266252013,1692266252240,1693238516363,482,227,255
815,1693238516363,1692266252389,1692266252608,1693238516762,399,219,180
816,1693238516762,1692266252700,1692266252909,1693238517153,391,209,182
817,1693238517153,1692266253115,1692266253331,1693238517453,300,216,84
818,1693238517453,1692266253448,1692266253684,1693238517807,354,236,118
819,1693238517807,1692266253738,1692266254008,1693238518203,396,270,126
820,1693238518203,1692266254159,1692266254353,1693238518475,272,194,78
821,1693238518475,1692266254489,1692266254685,1693238518807,332,196,136
822,1693238518807,1692266254722,1692266254938,1693238519249,442,216,226
823,1693238519249,1692266255172,1692266255410,1693238519539,290,238,52
824,1693238519539,1692266255529,1692266255764,1693238519886,347,235,112
825,1693238519886,1692266255828,1692266256043,1693238520301,415,215,200
826,1693238520301,1692266256231,1692266256445,1693238520567,266,214,52
827,1693238520567,1692266256464,1692266256690,1693238520815,248,226,22
828,1693238520815,1692266256738,1692266256981,1693238521103,288,243,45
829,1693238521103,1692266257277,1692266257466,1693238521589,486,189,297
830,1693238521589,1692266257639,1692266257842,1693238521964,375,203,172
831,1693238521964,1692266257924,1692266258144,1693238522396,432,220,212
832,1693238522396,1692266258317,1692266258525,1693238522653,257,208,49
833,1693238522653,1692266258698,1692266258924,1693238523054,401,226,175
834,1693238523054,1692266258997,1692266259226,1693238523445,391,229,162
835,1693238523445,1692266259370,1692266259601,1693238523724,279,231,48
836,1693238523724,1692266259726,1692266259913,1693238524049,325,187,138
837,1693238524049,1692266259980,1692266260156,1693238524492,443,176,267
838,1693238524492,1692266260419,1692266260632,1693238524754,262,213,49
839,1693238524754,1692266260680,1692266260881,1693238525034,280,201,79
840,1693238525034,1692266260952,1692266261136,1693238525259,225,184,41
841,1693238525259,1692266261183,1692266261346,1693238525540,281,163,118
842,1693238525548,1692266261472,1692266261634,1693238525756,208,162,46
843,1693238525756,1692266261686,1692266261848,1693238525970,214,162,52
844,1693238525970,1692266261887,1692266262050,1693238526172,202,163,39
845,1693238526172,1692266262088,1692266262250,1693238526589,417,162,255
846,1693238526589,1692266262510,1692266262672,1693238526794,205,162,43
847,1693238526794,1692266262697,1692266262860,1693238526982,188,163,25
848,1693238526982,1692266262922,1692266263087,1693238527209,227,165,62
849,1693238527209,1692266263140,1692266263303,1693238527640,431,163,268
850,1693238527640,1692266263593,1692266263756,1693238527893,253,163,90
851,1693238527893,1692266263809,1692266263974,1693238528095,202,165,37
852,1693238528095,1692266264028,1692266264193,1693238528319,224,165,59
853,1693238528319,1692266264255,1692266264418,1693238528688,369,163,206
854,1693238528689,1692266264627,1692266264789,1693238528911,222,162,60
855,1693238528911,1692266264845,1692266265007,1693238529129,218,162,56
856,1693238529129,1692266265078,1692266265242,1693238529364,235,164,71
857,1693238529364,1692266265273,1692266265434,1693238529735,371,161,210
858,1693238529735,1692266265642,1692266265804,1693238529926,191,162,29
859,1693238529926,1692266265850,1692266266013,1693238530134,208,163,45
860,1693238530134,1692266266059,1692266266224,1693238530345,211,165,46
861,1693238530346,1692266266294,1692266266457,1693238530788,442,163,279
862,1693238530788,1692266266701,1692266266863,1693238530984,196,162,34
863,1693238530984,1692266266949,1692266267117,1693238531239,255,168,87
864,1693238531239,1692266267184,1692266267346,1693238531468,229,162,67
865,1693238531468,1692266267389,1692266267551,1693238531839,371,162,209
866,1693238531839,1692266268248,1692266268411,1693238532540,701,163,538
867,1693238532540,1692266268527,1692266268691,1693238532892,352,164,188
868,1693238532893,1692266268976,1692266269138,1693238533275,382,162,220
869,1693238533275,1692266269445,1692266269610,1693238533934,659,165,494
870,1693238533934,1692266269906,1692266270069,1693238534190,256,163,93
871,1693238534190,1692266270226,1692266270389,1693238534514,324,163,161
872,1693238534514,1692266270551,1692266270714,1693238534978,464,163,301
873,1693238534978,1692266271031,1692266271194,1693238535380,402,163,239
874,1693238535380,1692266271392,1692266271554,1693238535678,298,162,136
875,1693238535679,1692266271651,1692266271813,1693238536040,361,162,199
876,1693238536040,1692266271964,1692266272130,1693238536267,227,166,61
877,1693238536267,1692266272192,1692266272354,1693238536745,478,162,316
878,1693238536745,1692266272705,1692266272868,1693238537339,594,163,431
879,1693238537339,1692266273724,1692266273888,1693238538851,1512,164,1348
880,1693238538852,1692266274832,1692266274994,1693238539369,517,162,355
881,1693238539369,1692266275299,1692266275461,1693238539893,524,162,362
882,1693238539893,1692266275894,1692266276057,1693238540418,525,163,362
883,1693238540418,1692266276398,1692266276560,1693238540940,522,162,360
884,1693238540940,1692266276900,1692266277063,1693238541465,525,163,362
885,1693238541465,1692266277409,1692266277571,1693238542514,1049,162,887
886,1693238542514,1692266278450,1692266278612,1693238543038,524,162,362
887,1693238543038,1692266279464,1692266279628,1693238543909,871,164,707
888,1693238543910,1692266279869,1692266280031,1693238544153,243,162,81
889,1693238544154,1692266280342,1692266280505,1693238544627,473,163,310
890,1693238544628,1692266280583,1692266280747,1693238544870,242,164,78
891,1693238544870,1692266280856,1692266281019,1693238545145,275,163,112
892,1693238545145,1692266281362,1692266281524,1693238545647,502,162,340
893,1693238545647,1692266281590,1692266281752,1693238545876,229,162,67
894,1693238545876,1692266281811,1692266281973,1693238546098,222,162,60
895,1693238546098,1692266282109,1692266282273,1693238546709,611,164,447
896,1693238546709,1692266282649,1692266282812,1693238547098,389,163,226
897,1693238547098,1692266283044,1692266283206,1693238547333,235,162,73
898,1693238547333,1692266283535,1692266283697,1693238547820,487,162,325
899,1693238547821,1692266283728,1692266283890,1693238548146,325,162,163
900,1693238548146,1692266284088,1692266284252,1693238548373,227,164,63
901,1693238548373,1692266284514,1692266284677,1693238548798,425,163,262
902,1693238548798,1692266284750,1692266284914,1693238549136,338,164,174
903,1693238549136,1692266285061,1692266285225,1693238549350,214,164,50
904,1693238549350,1692266285269,1692266285431,1693238549660,310,162,148
905,1693238549660,1692266285582,1692266285747,1693238549868,208,165,43
906,1693238549868,1692266285771,1692266285933,1693238550184,316,162,154
907,1693238550184,1692266286100,1692266286264,1693238550385,201,164,37
908,1693238550385,1692266286323,1692266286485,1693238550708,323,162,161
909,1693238550708,1692266286620,1692266286782,1693238550903,195,162,33
910,1693238550903,1692266286821,1692266286983,1693238551232,329,162,167
911,1693238551232,1692266287154,1692266287317,1693238551438,206,163,43
912,1693238551438,1692266287374,1692266287538,1693238551816,378,164,214
913,1693238551816,1692266287730,1692266287892,1693238552013,197,162,35
914,1693238552013,1692266287944,1692266288107,1693238552281,268,163,105
915,1693238552281,1692266288229,1692266288393,1693238552514,233,164,69
916,1693238552514,1692266288423,1692266288584,1693238552805,291,161,130
917,1693238552805,1692266288727,1692266288891,1693238553013,208,164,44
918,1693238553013,1692266288955,1692266289119,1693238553332,319,164,155
919,1693238553332,1692266289267,1692266289431,1693238553561,229,164,65
920,1693238553561,1692266289493,1692266289657,1693238553854,293,164,129
921,1693238553854,1692266289774,1692266289938,1693238554059,205,164,41
922,1693238554059,1692266289994,1692266290159,1693238554280,221,165,56
923,1693238554280,1692266290206,1692266290371,1693238554493,213,165,48
924,1693238554493,1692266290403,1692266290564,1693238554905,412,161,251
925,1693238554905,1692266290806,1692266290969,1693238555092,187,163,24
926,1693238555092,1692266291051,1692266291215,1693238555336,244,164,80
927,1693238555336,1692266291272,1692266291437,1693238555558,222,165,57
928,1693238555718,1692266291842,1692266292101,1693238556224,506,259,247
929,1693238556224,1692266292258,1692266292481,1693238556603,379,223,156
930,1693238556603,1692266292517,1692266292699,1693238557001,398,182,216
931,1693238557001,1692266292921,1692266293104,1693238557226,225,183,42
932,1693238557226,1692266293153,1692266293364,1693238557498,272,211,61
933,1693238557498,1692266293417,1692266293627,1693238557749,251,210,41
934,1693238557749,1692266293671,1692266293852,1693238558049,300,181,119
935,1693238558049,1692266293967,1692266294144,1693238558282,233,177,56
936,1693238558282,1692266294195,1692266294386,1693238558508,226,191,35
937,1693238558508,1692266294424,1692266294632,1693238558754,246,208,38
938,1693238558754,1692266294698,1692266294892,1693238559097,343,194,149
939,1693238559097,1692266295023,1692266295222,1693238559344,247,199,48
940,1693238559344,1692266295419,1692266295602,1693238559724,380,183,197
941,1693238559724,1692266295703,1692266295890,1693238560145,421,187,234
942,1693238560145,1692266296094,1692266296357,1693238560540,395,263,132
943,1693238560540,1692266296491,1692266296717,1693238560842,302,226,76
944,1693238560842,1692266296774,1692266296967,1693238561192,350,193,157
945,1693238561192,1692266297123,1692266297346,1693238561467,275,223,52
946,1693238561468,1692266297412,1692266297613,1693238561734,266,201,65
947,1693238561734,1692266297669,1692266297880,1693238562005,271,211,60
948,1693238562005,1692266298141,1692266298365,1693238562487,482,224,258
949,1693238562487,1692266298406,1692266298608,1693238562730,243,202,41
950,1693238562730,1692266298646,1692266298861,1693238562994,264,215,49
951,1693238562994,1692266298914,1692266299129,1693238563291,297,215,82
952,1693238563291,1692266299235,1692266299445,1693238563567,276,210,66
953,1693238563567,1692266299500,1692266299691,1693238563813,246,191,55
954,1693238563813,1692266299739,1692266299946,1693238564068,255,207,48
955,1693238564068,1692266299982,1692266300197,1693238564339,271,215,56
956,1693238564339,1692266300270,1692266300468,1693238564590,251,198,53
957,1693238564590,1692266300510,1692266300704,1693238564826,236,194,42
958,1693238564826,1692266300767,1692266300966,1693238565087,261,199,62
959,1693238565087,1692266301004,1692266301224,1693238565388,301,220,81
960,1693238565388,1692266301301,1692266301492,1693238565614,226,191,35
961,1693238565614,1692266301546,1692266301729,1693238565850,236,183,53
962,1693238565851,1692266301764,1692266301944,1693238566066,215,180,35
963,1693238566066,1692266301994,1692266302179,1693238566501,435,185,250
964,1693238566501,1692266302446,1692266302644,1693238567151,650,198,452
965,1693238567151,1692266303114,1692266303331,1693238567677,526,217,309
966,1693238567677,1692266303668,1692266303860,1693238568067,390,192,198
967,1693238568067,1692266304019,1692266304212,1693238568534,467,193,274
968,1693238568534,1692266304521,1692266304703,1693238569060,526,182,344
969,1693238569060,1692266304993,1692266305198,1693238569320,260,205,55
970,1693238569320,1692266305243,1692266305433,1693238569622,302,190,112
971,1693238569622,1692266305625,1692266305843,1693238570114,492,218,274
972,1693238570114,1692266306074,1692266306270,1693238570408,294,196,98
973,1693238570408,1692266306581,1692266306769,1693238570891,483,188,295
974,1693238570891,1692266307126,1692266307309,1693238571431,540,183,357
975,1693238571431,1692266307599,1692266307799,1693238571921,490,200,290
976,1693238571921,1692266307840,1692266308036,1693238572204,283,196,87
977,1693238572204,1692266308132,1692266308312,1693238572434,230,180,50
978,1693238572434,1692266308354,1692266308534,1693238572730,296,180,116
979,1693238572730,1692266308667,1692266308881,1693238573003,273,214,59
980,1693238573003,1692266308919,1692266309110,1693238573254,251,191,60
981,1693238573254,1692266309179,1692266309357,1693238573481,227,178,49
982,1693238573481,1692266309414,1692266309597,1693238573778,297,183,114
983,1693238573778,1692266309718,1692266309922,1693238574044,266,204,62
984,1693238574045,1692266309977,1692266310220,1693238574342,297,243,54
985,1693238574342,1692266310284,1692266310504,1693238574826,484,220,264
986,1693238574826,1692266310769,1692266310948,1693238575070,244,179,65
987,1693238575070,1692266311015,1692266311198,1693238575320,250,183,67
988,1693238575320,1692266311272,1692266311479,1693238575601,281,207,74
989,1693238575601,1692266311531,1692266311749,1693238575877,276,218,58
990,1693238575877,1692266311801,1692266311992,1693238576113,236,191,45
991,1693238576113,1692266312064,1692266312278,1693238576400,287,214,73
992,1693238576400,1692266312325,1692266312525,1693238576647,247,200,47
993,1693238576647,1692266312563,1692266312764,1693238576925,278,201,77
994,1693238576925,1692266312873,1692266313082,1693238577204,279,209,70
995,1693238577204,1692266313129,1692266313316,1693238577438,234,187,47
996,1693238577438,1692266313398,1692266313583,1693238577704,266,185,81
997,1693238577704,1692266313641,1692266313843,1693238577973,269,202,67
998,1693238577973,1692266313923,1692266314122,1693238578244,271,199,72
999,1693238578244,1692266314156,1692266314346,1693238578468,224,190,34
1000,1693238578468,1692266314371,1692266314567,1693238578688,220,196,24
1001,1693238578688,1692266314655,1692266314844,1693238579021,333,189,144
1002,1693238579021,1692266314938,1692266315121,1693238579242,221,183,38
1003,1693238579242,1692266315173,1692266315353,1693238579474,232,180,52
1004,1693238579474,1692266315400,1692266315582,1693238579704,230,182,48
1005,1693238579704,1692266315635,1692266315811,1693238580071,367,176,191
1006,1693238580072,1692266315992,1692266316184,1693238580306,234,192,42
1007,1693238580306,1692266316229,1692266316425,1693238580546,240,196,44
1008,1693238580546,1692266316474,1692266316661,1693238580782,236,187,49
1009,1693238580782,1692266316722,1692266316904,1693238581119,337,182,155
1010,1693238581119,1692266317054,1692266317242,1693238581364,245,188,57
1011,1693238581364,1692266317296,1692266317476,1693238581597,233,180,53
1012,1693238581597,1692266317524,1692266317708,1693238581834,237,184,53
1013,1693238581834,1692266317795,1692266317988,1693238582165,331,193,138
1014,1693238582165,1692266318102,1692266318307,1693238582429,264,205,59
1015,1693238582429,1692266318357,1692266318551,1693238582673,244,194,50
1016,1693238582673,1692266318602,1692266318794,1693238582916,243,192,51
1017,1693238582916,1692266318837,1692266319054,1693238583215,299,217,82
1018,1693238583215,1692266319166,1692266319358,1693238583480,265,192,73
1019,1693238583480,1692266319499,1692266319724,1693238583845,365,225,140
1020,1693238583846,1692266319800,1692266320001,1693238584264,418,201,217
1021,1693238584264,1692266320182,1692266320398,1693238584519,255,216,39
1022,1693238584519,1692266320445,1692266320645,1693238584766,247,200,47
1023,1693238584766,1692266320702,1692266320894,1693238585048,282,192,90
1024,1693238585048,1692266320967,1692266321189,1693238585314,266,222,44
1025,1693238585314,1692266321241,1692266321482,1693238585605,291,241,50
1026,1693238585605,1692266321632,1692266321795,1693238585926,321,163,158
1027,1693238585934,1692266321857,1692266322019,1693238586361,427,162,265
1028,1693238586361,1692266322277,1692266322439,1693238586560,199,162,37
1029,1693238586560,1692266322534,1692266322701,1693238586822,262,167,95
1030,1693238586822,1692266322740,1692266322902,1693238587042,220,162,58
1031,1693238587042,1692266322953,1692266323114,1693238587409,367,161,206
1032,1693238587409,1692266323336,1692266323500,1693238587621,212,164,48
1033,1693238587621,1692266323548,1692266323712,1693238587834,213,164,49
1034,1693238587834,1692266323793,1692266323957,1693238588079,245,164,81
1035,1693238588079,1692266324012,1692266324174,1693238588457,378,162,216
1036,1693238588457,1692266324392,1692266324555,1693238588677,220,163,57
1037,1693238588678,1692266324606,1692266324768,1693238588889,211,162,49
1038,1693238588889,1692266324805,1692266324966,1693238589088,199,161,38
1039,1693238589088,1692266325014,1692266325177,1693238589517,429,163,266
1040,1693238589517,1692266325436,1692266325601,1693238589735,218,165,53
1041,1693238589735,1692266325675,1692266325841,1693238589962,227,166,61
1042,1693238589962,1692266325881,1692266326042,1693238590163,201,161,40
1043,1693238590163,1692266326089,1692266326251,1693238590555,392,162,230
1044,1693238590555,1692266326460,1692266326623,1693238590744,189,163,26
1045,1693238590744,1692266326646,1692266326809,1693238590946,202,163,39
1046,1693238590946,1692266326889,1692266327053,1693238591174,228,164,64
1047,1693238591174,1692266327116,1692266327281,1693238591603,429,165,264
1048,1693238591604,1692266327527,1692266327691,1693238591813,209,164,45
1049,1693238591813,1692266327762,1692266327927,1693238592048,235,165,70
1050,1693238592048,1692266327960,1692266328122,1693238592242,194,162,32
1051,1693238592242,1692266328182,1692266328347,1693238592652,410,165,245
1052,1693238592652,1692266328576,1692266328738,1693238592881,229,162,67
1053,1693238592881,1692266328819,1692266328984,1693238593105,224,165,59
1054,1693238593105,1692266329033,1692266329197,1693238593332,227,164,63
1055,1693238593332,1692266329254,1692266329416,1693238593773,441,162,279
1056,1693238593773,1692266329681,1692266329844,1693238594162,389,163,226
1057,1693238594162,1692266330107,1692266330272,1693238594428,266,165,101
1058,1693238594429,1692266330365,1692266330528,1693238594748,319,163,156
1059,1693238594748,1692266330670,1692266330833,1693238594954,206,163,43
1060,1693238594954,1692266330893,1692266331056,1693238595176,222,163,59
1061,1693238595176,1692266331105,1692266331268,1693238595389,213,163,50
1062,1693238595389,1692266331331,1692266331495,1693238595821,432,164,268
1063,1693238595821,1692266331737,1692266331899,1693238596036,215,162,53
1064,1693238596036,1692266331947,1692266332109,1693238596230,194,162,32
1065,1693238596230,1692266332160,1692266332324,1693238596445,215,164,51
1066,1693238596445,1692266332384,1692266332548,1693238596846,401,164,237
1067,1693238596846,1692266332780,1692266332945,1693238597067,221,165,56
1068,1693238597067,1692266332994,1692266333159,1693238597280,213,165,48
1069,1693238597280,1692266333200,1692266333364,1693238597485,205,164,41
1070,1693238597485,1692266333420,1692266333585,1693238597895,410,165,245
1071,1693238597895,1692266333826,1692266333989,1693238598110,215,163,52
1072,1693238598110,1692266334034,1692266334197,1693238598319,209,163,46
1073,1693238598319,1692266334256,1692266334419,1693238598540,221,163,58
1074,1693238598540,1692266334467,1692266334632,1693238598943,403,165,238
1075,1693238598943,1692266334866,1692266335030,1693238599151,208,164,44
1076,1693238599151,1692266335077,1692266335239,1693238599360,209,162,47
1077,1693238599360,1692266335276,1692266335438,1693238599676,316,162,154
1078,1693238599676,1692266335583,1692266335745,1693238599996,320,162,158
1079,1693238599996,1692266335929,1692266336092,1693238600213,217,163,54
1080,1693238600213,1692266336146,1692266336312,1693238600433,220,166,54
1081,1693238600433,1692266336368,1692266336532,1693238600652,219,164,55
1082,1693238600652,1692266336599,1692266336762,1693238601040,388,163,225
1083,1693238601040,1692266336971,1692266337134,1693238601255,215,163,52
1084,1693238601255,1692266337163,1692266337326,1693238601447,192,163,29
1085,1693238601447,1692266337379,1692266337542,1693238601663,216,163,53
1086,1693238601663,1692266337584,1692266337747,1693238601868,205,163,42
1087,1693238601868,1692266337990,1692266338152,1693238602274,406,162,244
1088,1693238602274,1692266338236,1692266338398,1693238602519,245,162,83
1089,1693238602519,1692266338443,1692266338608,1693238602728,209,165,44
1090,1693238602728,1692266338635,1692266338796,1693238603137,409,161,248
1091,1693238603138,1692266339113,1692266339277,1693238603398,260,164,96
1092,1693238603399,1692266339330,1692266339494,1693238603615,216,164,52
1093,1693238603615,1692266339569,1692266339733,1693238603855,240,164,76
1094,1693238603855,1692266339823,1692266339987,1693238604187,332,164,168
1095,1693238604187,1692266340109,1692266340272,1693238604393,206,163,43
1096,1693238604393,1692266340318,1692266340481,1693238604602,209,163,46
1097,1693238604602,1692266340571,1692266340735,1693238604857,255,164,91
1098,1693238604857,1692266340783,1692266340946,1693238605234,377,163,214
1099,1693238605234,1692266341153,1692266341316,1693238605437,203,163,40
1100,1693238605437,1692266341379,1692266341543,1693238605664,227,164,63
1101,1693238605664,1692266341592,1692266341755,1693238605876,212,163,49
1102,1693238605876,1692266341821,1692266341984,1693238606293,417,163,254
1103,1693238606293,1692266342201,1692266342362,1693238606483,190,161,29
1104,1693238606483,1692266342410,1692266342573,1693238606700,217,163,54
1105,1693238606700,1692266342616,1692266342777,1693238606898,198,161,37
1106,1693238606898,1692266342812,1692266342973,1693238607094,196,161,35
1107,1693238607094,1692266343229,1692266343391,1693238607512,418,162,256
1108,1693238607512,1692266343429,1692266343590,1693238607724,212,161,51
1109,1693238607724,1692266343647,1692266343810,1693238607937,213,163,50
1110,1693238607937,1692266343858,1692266344020,1693238608141,204,162,42
1111,1693238608141,1692266344059,1692266344221,1693238608384,243,162,81
1112,1693238608384,1692266344292,1692266344453,1693238608574,190,161,29
1113,1693238608574,1692266344535,1692266344697,1693238608818,244,162,82
1114,1693238608818,1692266344745,1692266344908,1693238609028,210,163,47
1115,1693238609028,1692266344967,1692266345129,1693238609428,400,162,238
1116,1693238609428,1692266345342,1692266345503,1693238609624,196,161,35
1117,1693238609624,1692266345564,1692266345727,1693238609849,225,163,62
1118,1693238609849,1692266345778,1692266345940,1693238610061,212,162,50
1119,1693238610061,1692266345983,1692266346147,1693238610478,417,164,253
1120,1693238610478,1692266346414,1692266346576,1693238610697,219,162,57
1121,1693238610697,1692266346609,1692266346771,1693238610892,195,162,33
1122,1693238610892,1692266346822,1692266346985,1693238611106,214,163,51
1123,1693238611106,1692266347025,1692266347187,1693238611308,202,162,40
1124,1693238611308,1692266347436,1692266347600,1693238611720,412,164,248
1125,1693238611721,1692266347679,1692266347841,1693238611962,241,162,79
1126,1693238611962,1692266347873,1692266348035,1693238612156,194,162,32
1127,1693238612156,1692266348075,1692266348237,1693238612574,418,162,256
1128,1693238612574,1692266348506,1692266348669,1693238612790,216,163,53
1129,1693238612790,1692266348723,1692266348887,1693238613008,218,164,54
1130,1693238613008,1692266348937,1692266349100,1693238613221,213,163,50
1131,1693238613221,1692266349144,1692266349307,1693238613624,403,163,240
1132,1693238613624,1692266349542,1692266349704,1693238613825,201,162,39
1133,1693238613825,1692266349742,1692266349903,1693238614024,199,161,38
1134,1693238614024,1692266349935,1692266350097,1693238614228,204,162,42
1135,1693238614228,1692266350149,1692266350314,1693238614453,225,165,60
1136,1693238614453,1692266350578,1692266350742,1693238614862,409,164,245
1137,1693238614863,1692266350826,1692266350989,1693238615109,246,163,83
1138,1693238615109,1692266351019,1692266351181,1693238615302,193,162,31
1139,1693238615302,1692266351260,1692266351424,1693238615720,418,164,254
1140,1693238615720,1692266351635,1692266351797,1693238615920,200,162,38
1141,1693238615920,1692266351843,1692266352006,1693238616138,218,163,55
1142,1693238616303,1692266352228,1692266352437,1693238616769,466,209,257
1143,1693238616769,1692266352689,1692266352874,1693238616994,225,185,40
1144,1693238616995,1692266352905,1692266353091,1693238617212,217,186,31
1145,1693238617212,1692266353154,1692266353369,1693238617490,278,215,63
1146,1693238617490,1692266353434,1692266353650,1693238617819,329,216,113
1147,1693238617819,1692266353726,1692266353935,1693238618056,237,209,28
1148,1693238618056,1692266353985,1692266354230,1693238618352,296,245,51
1149,1693238618352,1692266354288,1692266354513,1693238618635,283,225,58
1150,1693238618635,1692266354787,1692266355021,1693238619143,508,234,274
1151,1693238619143,1692266355186,1692266355411,1693238619532,389,225,164
1152,1693238619533,1692266355485,1692266355709,1693238619919,386,224,162
1153,1693238619919,1692266355822,1692266356033,1693238620155,236,211,25
1154,1693238620155,1692266356064,1692266356282,1693238620412,257,218,39
1155,1693238620412,1692266356354,1692266356573,1693238620694,282,219,63
1156,1693238620694,1692266356634,1692266356883,1693238621005,311,249,62
1157,1693238621005,1692266356947,1692266357168,1693238621358,353,221,132
1158,1693238621358,1692266357282,1692266357478,1693238621599,241,196,45
1159,1693238621599,1692266357512,1692266357717,1693238622012,413,205,208
1160,1693238622012,1692266357952,1692266358201,1693238622402,390,249,141
1161,1693238622402,1692266358366,1692266358598,1693238622720,318,232,86
1162,1693238622720,1692266358662,1692266358919,1693238623060,340,257,83
1163,1693238623060,1692266358989,1692266359208,1693238623329,269,219,50
1164,1693238623330,1692266359365,1692266359559,1693238623680,350,194,156
1165,1693238623680,1692266359603,1692266359816,1693238624110,430,213,217
1166,1693238624110,1692266360031,1692266360241,1693238624363,253,210,43
1167,1693238624363,1692266360303,1692266360520,1693238624641,278,217,61
1168,1693238624641,1692266360555,1692266360774,1693238624895,254,219,35
1169,1693238624895,1692266360824,1692266361026,1693238625158,263,202,61
1170,1693238625158,1692266361085,1692266361276,1693238625398,240,191,49
1171,1693238625398,1692266361324,1692266361560,1693238625681,283,236,47
1172,1693238625681,1692266361626,1692266361819,1693238625940,259,193,66
1173,1693238625941,1692266362095,1692266362298,1693238626418,477,203,274
1174,1693238626418,1692266362368,1692266362564,1693238626919,501,196,305
1175,1693238626919,1692266362824,1692266363024,1693238627446,527,200,327
1176,1693238627446,1692266363357,1692266363552,1693238627837,391,195,196
1177,1693238627837,1692266363744,1692266363947,1693238628068,231,203,28
1178,1693238628068,1692266364250,1692266364466,1693238628587,519,216,303
1179,1693238628587,1692266364751,1692266364937,1693238629058,471,186,285
1180,1693238629058,1692266364979,1692266365195,1693238629316,258,216,42
1181,1693238629316,1692266365244,1692266365505,1693238629678,362,261,101
1182,1693238629678,1692266365620,1692266365840,1693238629961,283,220,63
1183,1693238629961,1692266365892,1692266366094,1693238630215,254,202,52
1184,1693238630216,1692266366143,1692266366364,1693238630485,269,221,48
1185,1693238630485,1692266366381,1692266366624,1693238630745,260,243,17
1186,1693238630745,1692266366691,1692266366994,1693238631152,407,303,104
1187,1693238631152,1692266367091,1692266367294,1693238631415,263,203,60
1188,1693238631415,1692266367344,1692266367527,1693238631648,233,183,50
1189,1693238631648,1692266367570,1692266367759,1693238631880,232,189,43
1190,1693238631880,1692266367799,1692266367978,1693238632098,218,179,39
1191,1693238632099,1692266368025,1692266368208,1693238632329,230,183,47
1192,1693238632329,1692266368244,1692266368437,1693238632557,228,193,35
1193,1693238632558,1692266368477,1692266368671,1693238632792,234,194,40
1194,1693238632792,1692266368731,1692266368934,1693238633055,263,203,60
1195,1693238633055,1692266369001,1692266369254,1693238633375,320,253,67
1196,1693238633375,1692266369312,1692266369521,1693238633642,267,209,58
1197,1693238633642,1692266369567,1692266369751,1693238633873,231,184,47
1198,1693238633873,1692266369822,1692266370020,1693238634142,269,198,71
1199,1693238634142,1692266370076,1692266370280,1693238634405,263,204,59
1200,1693238634405,1692266370324,1692266370512,1693238634632,227,188,39
1201,1693238634632,1692266370551,1692266370754,1693238634875,243,203,40
1202,1693238634875,1692266370800,1692266371032,1693238635153,278,232,46
1203,1693238635153,1692266371101,1692266371335,1693238635457,304,234,70
1204,1693238635457,1692266371404,1692266371617,1693238635738,281,213,68
1205,1693238635738,1692266371676,1692266371871,1693238635991,253,195,58
1206,1693238635991,1692266371916,1692266372137,1693238636258,267,221,46
1207,1693238636258,1692266372197,1692266372395,1693238636516,258,198,60
1208,1693238636516,1692266372451,1692266372657,1693238636778,262,206,56
1209,1693238636778,1692266372699,1692266372901,1693238637022,244,202,42
1210,1693238637022,1692266372947,1692266373172,1693238637294,272,225,47
1211,1693238637295,1692266373220,1692266373418,1693238637540,245,198,47
1212,1693238637540,1692266373472,1692266373668,1693238637789,249,196,53
1213,1693238637789,1692266373717,1692266373961,1693238638082,293,244,49
1214,1693238638083,1692266374026,1692266374308,1693238638449,366,282,84
1215,1693238638449,1692266374383,1692266374590,1693238638710,261,207,54
1216,1693238638710,1692266374639,1692266374866,1693238638988,278,227,51
1217,1693238638988,1692266374928,1692266375175,1693238639296,308,247,61
1218,1693238639296,1692266375226,1692266375440,1693238639562,266,214,52
1219,1693238639562,1692266375488,1692266375706,1693238639826,264,218,46
1220,1693238639826,1692266375729,1692266375968,1693238640089,263,239,24
1221,1693238640089,1692266376011,1692266376244,1693238640366,277,233,44
1222,1693238640366,1692266376296,1692266376519,1693238640690,324,223,101
1223,1693238640690,1692266376626,1692266376844,1693238640965,275,218,57
1224,1693238640965,1692266376890,1692266377110,1693238641231,266,220,46
1225,1693238641231,1692266377146,1692266377358,1693238641523,292,212,80
1226,1693238641523,1692266377440,1692266377625,1693238641746,223,185,38
1227,1693238641746,1692266377655,1692266377836,1693238641963,217,181,36
1228,1693238641963,1692266377876,1692266378060,1693238642181,218,184,34
1229,1693238642181,1692266378110,1692266378303,1693238642423,242,193,49
1230,1693238642423,1692266378349,1692266378565,1693238642763,340,216,124
1231,1693238642763,1692266378679,1692266378914,1693238643035,272,235,37
1232,1693238643035,1692266378982,1692266379210,1693238643331,296,228,68
1233,1693238643331,1692266379236,1692266379437,1693238643558,227,201,26
1234,1693238643558,1692266379478,1692266379668,1693238643789,231,190,41
1235,1693238643789,1692266379716,1692266379917,1693238644038,249,201,48
1236,1693238644038,1692266379955,1692266380186,1693238644307,269,231,38
1237,1693238644307,1692266380228,1692266380459,1693238644580,273,231,42
1238,1693238644580,1692266380521,1692266380732,1693238644856,276,211,65
1239,1693238644856,1692266380776,1692266381008,1693238645129,273,232,41
1240,1693238645130,1692266381043,1692266381256,1693238645378,248,213,35
1241,1693238645378,1692266381294,1692266381517,1693238645638,260,223,37
1242,1693238645638,1692266381545,1692266381765,1693238645886,248,220,28
1243,1693238645886,1692266381805,1692266382028,1693238646149,263,223,40
1244,1693238646150,1692266382076,1692266382266,1693238646386,236,190,46
1245,1693238646393,1692266382335,1692266382500,1693238646620,227,165,62
1246,1693238646620,1692266382543,1692266382705,1693238646825,205,162,43
1247,1693238646825,1692266382745,1692266382909,1693238647029,204,164,40
1248,1693238647029,1692266382934,1692266383096,1693238647217,188,162,26
1249,1693238647217,1692266383132,1692266383295,1693238647416,199,163,36
1250,1693238647416,1692266383326,1692266383488,1693238647608,192,162,30
1251,1693238647608,1692266383532,1692266383694,1693238647815,207,162,45
1252,1693238647815,1692266383729,1692266383893,1693238648013,198,164,34
1253,1693238648013,1692266383933,1692266384096,1693238648217,204,163,41
1254,1693238648217,1692266384132,1692266384294,1693238648414,197,162,35
1255,1693238648414,1692266384342,1692266384506,1693238648626,212,164,48
1256,1693238648626,1692266384545,1692266384707,1693238648827,201,162,39
1257,1693238648827,1692266384761,1692266384925,1693238649046,219,164,55
1258,1693238649046,1692266384982,1692266385146,1693238649301,255,164,91
1259,1693238649301,1692266385222,1692266385386,1693238649509,208,164,44
1260,1693238649509,1692266385426,1692266385589,1693238649709,200,163,37
1261,1693238649709,1692266385635,1692266385798,1693238649918,209,163,46
1262,1693238649918,1692266385836,1692266386000,1693238650120,202,164,38
1263,1693238650120,1692266386057,1692266386221,1693238650342,222,164,58
1264,1693238650342,1692266386272,1692266386437,1693238650557,215,165,50
1265,1693238650558,1692266386469,1692266386633,1693238650753,195,164,31
1266,1693238650753,1692266386664,1692266386825,1693238650946,193,161,32
1267,1693238650946,1692266386867,1692266387029,1693238651149,203,162,41
1268,1693238651149,1692266387067,1692266387231,1693238651351,202,164,38
1269,1693238651351,1692266387268,1692266387431,1693238651551,200,163,37
1270,1693238651551,1692266387467,1692266387629,1693238651749,198,162,36
1271,1693238651749,1692266387671,1692266387833,1693238651954,205,162,43
1272,1693238651954,1692266387893,1692266388056,1693238652176,222,163,59
1273,1693238652176,1692266388108,1692266388270,1693238652390,214,162,52
1274,1693238652390,1692266388321,1692266388485,1693238652606,216,164,52
1275,1693238652606,1692266388515,1692266388678,1693238652798,192,163,29
1276,1693238652798,1692266388722,1692266388885,1693238653005,207,163,44
1277,1693238653005,1692266388930,1692266389094,1693238653214,209,164,45
1278,1693238653214,1692266389133,1692266389298,1693238653418,204,165,39
1279,1693238653418,1692266389335,1692266389498,1693238653619,201,163,38
1280,1693238653619,1692266389567,1692266389733,1693238653853,234,166,68
1281,1693238653853,1692266389791,1692266389955,1693238654075,222,164,58
1282,1693238654075,1692266389988,1692266390149,1693238654270,195,161,34
1283,1693238654270,1692266390202,1692266390365,1693238654485,215,163,52
1284,1693238654485,1692266390402,1692266390564,1693238654684,199,162,37
1285,1693238654684,1692266390599,1692266390762,1693238654882,198,163,35
1286,1693238654882,1692266390807,1692266390970,1693238655090,208,163,45
1287,1693238655090,1692266391046,1692266391213,1693238655333,243,167,76
1288,1693238655333,1692266391253,1692266391415,1693238655536,203,162,41
1289,1693238655536,1692266391498,1692266391665,1693238655785,249,167,82
1290,1693238655785,1692266391712,1692266391877,1693238655997,212,165,47
1291,1693238655997,1692266391934,1692266392099,1693238656219,222,165,57
1292,1693238656219,1692266392134,1692266392297,1693238656417,198,163,35
1293,1693238656417,1692266392338,1692266392501,1693238656621,204,163,41
1294,1693238656621,1692266392539,1692266392701,1693238656821,200,162,38
1295,1693238656821,1692266392755,1692266392919,1693238657040,219,164,55
1296,1693238657040,1692266392970,1692266393133,1693238657254,214,163,51
1297,1693238657254,1692266393186,1692266393351,1693238657471,217,165,52
1298,1693238657472,1692266393393,1692266393556,1693238657676,204,163,41
1299,1693238657676,1692266393605,1692266393767,1693238657887,211,162,49
1300,1693238657887,1692266393836,1692266394000,1693238658121,234,164,70
1301,1693238658121,1692266394031,1692266394193,1693238658314,193,162,31
1302,1693238658314,1692266394251,1692266394415,1693238658535,221,164,57
1303,1693238658535,1692266394455,1692266394617,1693238658737,202,162,40
1304,1693238658737,1692266394651,1692266394812,1693238658932,195,161,34
1305,1693238658932,1692266394852,1692266395015,1693238659135,203,163,40
1306,1693238659135,1692266395046,1692266395208,1693238659329,194,162,32
1307,1693238659329,1692266395247,1692266395410,1693238659622,293,163,130
1308,1693238659622,1692266395582,1692266395745,1693238659865,243,163,80
1309,1693238659865,1692266395815,1692266395979,1693238660099,234,164,70
1310,1693238660099,1692266396004,1692266396165,1693238660286,187,161,26
1311,1693238660286,1692266396214,1692266396377,1693238660498,212,163,49
1312,1693238660498,1692266396426,1692266396588,1693238660708,210,162,48
1313,1693238660708,1692266396633,1692266396796,1693238660916,208,163,45
1314,1693238660916,1692266396835,1692266396997,1693238661118,202,162,40
1315,1693238661118,1692266397036,1692266397199,1693238661319,201,163,38
1316,1693238661319,1692266397231,1692266397393,1693238661513,194,162,32
1317,1693238661514,1692266397453,1692266397617,1693238661737,223,164,59
1318,1693238661737,1692266397651,1692266397814,1693238661934,197,163,34
1319,1693238661934,1692266397869,1692266398034,1693238662154,220,165,55
1320,1693238662154,1692266398103,1692266398267,1693238662387,233,164,69
1321,1693238662387,1692266398293,1692266398455,1693238662575,188,162,26
1322,1693238662576,1692266398544,1692266398708,1693238662830,254,164,90
1323,1693238662830,1692266398785,1692266398949,1693238663069,239,164,75
1324,1693238663069,1692266398993,1692266399156,1693238663277,208,163,45
1325,1693238663277,1692266399228,1692266399393,1693238663513,236,165,71
1326,1693238663513,1692266399454,1692266399618,1693238663738,225,164,61
1327,1693238663738,1692266399662,1692266399824,1693238663945,207,162,45
1328,1693238663945,1692266399864,1692266400026,1693238664146,201,162,39
1329,1693238664146,1692266400066,1692266400229,1693238664349,203,163,40
1330,1693238664349,1692266400293,1692266400456,1693238664576,227,163,64
1331,1693238664576,1692266400493,1692266400655,1693238664775,199,162,37
1332,1693238664775,1692266400717,1692266400880,1693238665000,225,163,62
1333,1693238665000,1692266400915,1692266401077,1693238665197,197,162,35
1334,1693238665197,1692266401134,1692266401297,1693238665417,220,163,57
1335,1693238665418,1692266401332,1692266401495,1693238665614,196,163,33
1336,1693238665614,1692266401519,1692266401682,1693238665802,188,163,25
1337,1693238665802,1692266401710,1692266401872,1693238665992,190,162,28
1338,1693238665992,1692266401889,1692266402050,1693238666170,178,161,17
1339,1693238666170,1692266402099,1692266402261,1693238666381,211,162,49
1340,1693238666381,1692266402315,1692266402478,1693238666599,218,163,55
1341,1693238666599,1692266402513,1692266402675,1693238666796,197,162,35
1342,1693238666796,1692266402720,1692266402882,1693238667002,206,162,44
1343,1693238667002,1692266402958,1692266403123,1693238667243,241,165,76
1344,1693238667243,1692266403157,1692266403321,1693238667441,198,164,34
1345,1693238667441,1692266403368,1692266403532,1693238667652,211,164,47
1346,1693238667652,1692266403590,1692266403753,1693238667873,221,163,58
1347,1693238667873,1692266403801,1692266403965,1693238668086,213,164,49
1348,1693238668086,1692266403998,1692266404162,1693238668282,196,164,32
1349,1693238668282,1692266404207,1692266404369,1693238668489,207,162,45
1350,1693238668489,1692266404410,1692266404573,1693238668693,204,163,41
1351,1693238668693,1692266404625,1692266404788,1693238668908,215,163,52
1352,1693238668908,1692266404838,1692266405002,1693238669122,214,164,50
1353,1693238669122,1692266405038,1692266405201,1693238669321,199,163,36
1354,1693238669321,1692266405239,1692266405400,1693238669520,199,161,38
1355,1693238669520,1692266405418,1692266405581,1693238669702,182,163,19
1356,1693238669702,1692266405613,1692266405774,1693238669895,193,161,32
1357,1693238669895,1692266405818,1692266405981,1693238670101,206,163,43
1358,1693238670102,1692266406009,1692266406171,1693238670291,189,162,27
1359,1693238670292,1692266406205,1692266406367,1693238670487,195,162,33
1360,1693238670487,1692266406400,1692266406562,1693238670682,195,162,33
1361,1693238670682,1692266406608,1692266406771,1693238670891,209,163,46
1362,1693238670891,1692266406842,1692266407008,1693238671129,238,166,72
1363,1693238671129,1692266407041,1692266407202,1693238671322,193,161,32
1364,1693238671322,1692266407266,1692266407430,1693238671550,228,164,64
1365,1693238671550,1692266407483,1692266407647,1693238671767,217,164,53
1366,1693238671767,1692266407685,1692266407848,1693238671968,201,163,38
1367,1693238671968,1692266407890,1692266408053,1693238672173,205,163,42
1368,1693238672173,1692266408083,1692266408245,1693238672365,192,162,30
1369,1693238672365,1692266408284,1692266408446,1693238672566,201,162,39
1370,1693238672566,1692266408486,1692266408650,1693238672770,204,164,40
1371,1693238672770,1692266408673,1692266408835,1693238672955,185,162,23
1372,1693238672955,1692266408885,1692266409049,1693238673172,217,164,53
1373,1693238673172,1692266409091,1692266409253,1693238673374,202,162,40
1374,1693238673374,1692266409283,1692266409444,1693238673564,190,161,29
1375,1693238673565,1692266409492,1692266409655,1693238673775,210,163,47
1376,1693238673775,1692266409686,1692266409847,1693238673967,192,161,31
1377,1693238673967,1692266409909,1692266410072,1693238674192,225,163,62
1378,1693238674192,1692266410133,1692266410297,1693238674417,225,164,61
1379,1693238674417,1692266410347,1692266410512,1693238674632,215,165,50
1380,1693238674632,1692266410579,1692266410744,1693238674864,232,165,67
1381,1693238674864,1692266410774,1692266410936,1693238675056,192,162,30
1382,1693238675056,1692266410971,1692266411132,1693238675253,197,161,36
1383,1693238675253,1692266411180,1692266411346,1693238675466,213,166,47
1384,1693238675466,1692266411378,1692266411540,1693238675660,194,162,32
1385,1693238675660,1692266411612,1692266411778,1693238675898,238,166,72
1386,1693238675898,1692266411812,1692266411973,1693238676093,195,161,34
1387,1693238676093,1692266412015,1692266412178,1693238676298,205,163,42
1388,1693238676298,1692266412225,1692266412387,1693238676507,209,162,47
1389,1693238676668,1692266412588,1692266412808,1693238676929,261,220,41
1390,1693238676929,1692266412861,1692266413058,1693238677178,249,197,52
1391,1693238677178,1692266413097,1692266413301,1693238677476,298,204,94
1392,1693238677476,1692266413389,1692266413603,1693238677783,307,214,93
1393,1693238677783,1692266413694,1692266413887,1693238678007,224,193,31
1394,1693238678007,1692266413914,1692266414106,1693238678227,220,192,28
1395,1693238678227,1692266414169,1692266414370,1693238678491,264,201,63
1396,1693238678491,1692266414430,1692266414623,1693238678744,253,193,60
1397,1693238678744,1692266414677,1692266414864,1693238678984,240,187,53
1398,1693238678984,1692266414904,1692266415093,1693238679214,230,189,41
1399,1693238679214,1692266415146,1692266415324,1693238679444,230,178,52
1400,1693238679444,1692266415393,1692266415582,1693238679703,259,189,70
1401,1693238679703,1692266415637,1692266415850,1693238679970,267,213,54
1402,1693238679971,1692266415892,1692266416105,1693238680226,255,213,42
1403,1693238680226,1692266416170,1692266416389,1693238680510,284,219,65
1404,1693238680510,1692266416443,1692266416644,1693238680764,254,201,53
1405,1693238680764,1692266416682,1692266416893,1693238681014,250,211,39
1406,1693238681014,1692266416950,1692266417161,1693238681281,267,211,56
1407,1693238681281,1692266417283,1692266417499,1693238681621,340,216,124
1408,1693238681621,1692266417541,1692266417756,1693238681877,256,215,41
1409,1693238681877,1692266417838,1692266418071,1693238682198,321,233,88
1410,1693238682198,1692266418117,1692266418326,1693238682447,249,209,40
1411,1693238682447,1692266418372,1692266418591,1693238682712,265,219,46
1412,1693238682713,1692266418674,1692266418902,1693238683022,309,228,81
1413,1693238683022,1692266418945,1692266419163,1693238683305,283,218,65
1414,1693238683305,1692266419219,1692266419431,1693238683551,246,212,34
1415,1693238683551,1692266419458,1692266419656,1693238683777,226,198,28
1416,1693238683777,1692266419713,1692266419931,1693238684052,275,218,57
1417,1693238684052,1692266420034,1692266420278,1693238684440,388,244,144
1418,1693238684440,1692266420351,1692266420544,1693238684665,225,193,32
1419,1693238684665,1692266420600,1692266420805,1693238684951,286,205,81
1420,1693238684951,1692266420882,1692266421144,1693238685265,314,262,52
1421,1693238685265,1692266421183,1692266421417,1693238685537,272,234,38
1422,1693238685538,1692266421463,1692266421709,1693238685869,331,246,85
1423,1693238685869,1692266421797,1692266422066,1693238686279,410,269,141
1424,1693238686279,1692266422194,1692266422453,1693238686622,343,259,84
1425,1693238686622,1692266422542,1692266422751,1693238686893,271,209,62
1426,1693238686893,1692266422818,1692266423047,1693238687168,275,229,46
1427,1693238687168,1692266423117,1692266423354,1693238687496,328,237,91
1428,1693238687496,1692266423416,1692266423656,1693238687803,307,240,67
1429,1693238687803,1692266423732,1692266423953,1693238688125,322,221,101
1430,1693238688125,1692266424055,1692266424247,1693238688368,243,192,51
1431,1693238688368,1692266424261,1692266424454,1693238688574,206,193,13
1432,1693238688574,1692266424490,1692266424731,1693238688851,277,241,36
1433,1693238688851,1692266424772,1692266425004,1693238689149,298,232,66
1434,1693238689149,1692266425096,1692266425301,1693238689422,273,205,68
1435,1693238689422,1692266425353,1692266425543,1693238689684,262,190,72
1436,1693238689684,1692266425610,1692266425794,1693238689914,230,184,46
1437,1693238689914,1692266425837,1692266426014,1693238690134,220,177,43
1438,1693238690134,1692266426076,1692266426250,1693238690370,236,174,62
1439,1693238690370,1692266426299,1692266426480,1693238690601,231,181,50
1440,1693238690601,1692266426520,1692266426730,1693238690852,251,210,41
1441,1693238690852,1692266426785,1692266426985,1693238691105,253,200,53
1442,1693238691105,1692266427015,1692266427205,1693238691325,220,190,30
1443,1693238691325,1692266427252,1692266427474,1693238691594,269,222,47
1444,1693238691594,1692266427513,1692266427706,1693238691826,232,193,39
1445,1693238691826,1692266427744,1692266427934,1693238692054,228,190,38
1446,1693238692054,1692266427979,1692266428202,1693238692423,369,223,146
1447,1693238692423,1692266428344,1692266428545,1693238692730,307,201,106
1448,1693238692730,1692266428660,1692266428879,1693238692999,269,219,50
1449,1693238692999,1692266428915,1692266429155,1693238693275,276,240,36
1450,1693238693276,1692266429246,1692266429463,1693238693584,308,217,91
1451,1693238693584,1692266429493,1692266429688,1693238693809,225,195,30
1452,1693238693809,1692266429737,1692266429970,1693238694125,316,233,83
1453,1693238694125,1692266430041,1692266430295,1693238694474,349,254,95
1454,1693238694474,1692266430391,1692266430606,1693238694726,252,215,37
1455,1693238694726,1692266430646,1692266430837,1693238694957,231,191,40
1456,1693238694957,1692266430887,1692266431096,1693238695217,260,209,51
1457,1693238695217,1692266431154,1692266431357,1693238695477,260,203,57
1458,1693238695477,1692266431390,1692266431588,1693238695708,231,198,33
1459,1693238695708,1692266431638,1692266431857,1693238695977,269,219,50
1460,1693238695977,1692266431906,1692266432112,1693238696233,256,206,50
1461,1693238696233,1692266432155,1692266432375,1693238696495,262,220,42
1462,1693238696495,1692266432410,1692266432614,1693238696829,334,204,130
1463,1693238696829,1692266432759,1692266432945,1693238697065,236,186,50
1464,1693238697065,1692266432990,1692266433178,1693238697297,232,188,44
1465,1693238697297,1692266433261,1692266433474,1693238697594,297,213,84
1466,1693238697594,1692266433514,1692266433712,1693238697831,237,198,39
1467,1693238697831,1692266433767,1692266433950,1693238698070,239,183,56
1468,1693238698070,1692266434030,1692266434248,1693238698369,299,218,81
1469,1693238698369,1692266434303,1692266434501,1693238698621,252,198,54
1470,1693238698621,1692266434541,1692266434726,1693238698846,225,185,40
1471,1693238698846,1692266434771,1692266434968,1693238699089,243,197,46
1472,1693238699089,1692266435072,1692266435298,1693238699418,329,226,103
1473,1693238699418,1692266435348,1692266435539,1693238699659,241,191,50
1474,1693238699659,1692266435592,1692266435810,1693238699930,271,218,53
1475,1693238699930,1692266435863,1692266436065,1693238700186,256,202,54
1476,1693238700186,1692266436130,1692266436323,1693238700443,257,193,64
1477,1693238700443,1692266436379,1692266436580,1693238700701,258,201,57
1478,1693238700701,1692266436641,1692266436851,1693238701027,326,210,116
1479,1693238701027,1692266436934,1692266437162,1693238701334,307,228,79
1480,1693238701334,1692266437247,1692266437464,1693238701584,250,217,33
1481,1693238701584,1692266437505,1692266437694,1693238701814,230,189,41
1482,1693238701814,1692266437747,1692266437966,1693238702130,316,219,97
1483,1693238702130,1692266438040,1692266438278,1693238702398,268,238,30
1484,1693238702398,1692266438330,1692266438581,1693238702701,303,251,52
1485,1693238702701,1692266438641,1692266438876,1693238702996,295,235,60
1486,1693238702996,1692266438932,1692266439129,1693238703253,257,197,60
1487,1693238703253,1692266439169,1692266439395,1693238703515,262,226,36
1488,1693238703515,1692266439426,1692266439675,1693238703797,282,249,33
1489,1693238703797,1692266439728,1692266439944,1693238704099,302,216,86
1490,1693238704099,1692266440017,1692266440214,1693238704334,235,197,38
1491,1693238704334,1692266440252,1692266440439,1693238704558,224,187,37
1492,1693238704558,1692266440488,1692266440682,1693238704802,244,194,50
1493,1693238704802,1692266440725,1692266440926,1693238705046,244,201,43
1494,1693238705046,1692266440968,1692266441166,1693238705288,242,198,44
1495,1693238705288,1692266441215,1692266441432,1693238705552,264,217,47
1496,1693238705553,1692266441480,1692266441689,1693238705809,256,209,47
1497,1693238705810,1692266441734,1692266441931,1693238706051,241,197,44
1498,1693238706051,1692266442012,1692266442218,1693238706352,301,206,95
1499,1693238706352,1692266442308,1692266442545,1693238706665,313,237,76
1500,1693238706665,1692266442593,1692266442756,1693238706875,210,163,47
1501,1693238706882,1692266442796,1692266442958,1693238707171,289,162,127
1502,1693238707171,1692266443082,1692266443244,1693238707363,192,162,30
1503,1693238707363,1692266443298,1692266443463,1693238707582,219,165,54
1504,1693238707582,1692266443504,1692266443667,1693238707786,204,163,41
1505,1693238707786,1692266443702,1692266443865,1693238707988,202,163,39
1506,1693238707988,1692266443923,1692266444086,1693238708206,218,163,55
1507,1693238708206,1692266444140,1692266444303,1693238708422,216,163,53
1508,1693238708422,1692266444363,1692266444528,1693238708648,226,165,61
1509,1693238708648,1692266444591,1692266444755,1693238708875,227,164,63
1510,1693238708875,1692266444804,1692266444967,1693238709087,212,163,49
1511,1693238709087,1692266445037,1692266445200,1693238709320,233,163,70
1512,1693238709320,1692266445234,1692266445396,1693238709515,195,162,33
1513,1693238709515,1692266445446,1692266445609,1693238709729,214,163,51
1514,1693238709729,1692266445647,1692266445809,1693238709928,199,162,37
1515,1693238709928,1692266445855,1692266446019,1693238710141,213,164,49
1516,1693238710141,1692266446063,1692266446226,1693238710346,205,163,42
1517,1693238710346,1692266446292,1692266446457,1693238710577,231,165,66
1518,1693238710577,1692266446495,1692266446659,1693238710778,201,164,37
1519,1693238710778,1692266446723,1692266446888,1693238711008,230,165,65
1520,1693238711008,1692266446935,1692266447098,1693238711217,209,163,46
1521,1693238711217,1692266447142,1692266447305,1693238711425,208,163,45
1522,1693238711425,1692266447350,1692266447513,1693238711633,208,163,45
1523,1693238711633,1692266447555,1692266447718,1693238711838,205,163,42
1524,1693238711838,1692266447800,1692266447964,1693238712087,249,164,85
1525,1693238712088,1692266448021,1692266448183,1693238712306,218,162,56
1526,1693238712307,1692266448239,1692266448402,1693238712521,214,163,51
1527,1693238712521,1692266448440,1692266448603,1693238712722,201,163,38
1528,1693238712722,1692266448631,1692266448793,1693238712913,191,162,29
1529,1693238712913,1692266448853,1692266449016,1693238713136,223,163,60
1530,1693238713136,1692266449054,1692266449216,1693238713335,199,162,37
1531,1693238713336,1692266449239,1692266449402,1693238713522,186,163,23
1532,1693238713522,1692266449454,1692266449617,1693238713737,215,163,52
1533,1693238713737,1692266449661,1692266449824,1693238713943,206,163,43
1534,1693238713943,1692266449872,1692266450035,1693238714155,212,163,49
1535,1693238714155,1692266450084,1692266450246,1693238714366,211,162,49
1536,1693238714366,1692266450290,1692266450453,1693238714573,207,163,44
1537,1693238714573,1692266450497,1692266450660,1693238714780,207,163,44
1538,1693238714780,1692266450685,1692266450848,1693238714968,188,163,25
1539,1693238714968,1692266450887,1692266451048,1693238715168,200,161,39
1540,1693238715168,1692266451101,1692266451266,1693238715386,218,165,53
1541,1693238715386,1692266451317,1692266451481,1693238715601,215,164,51
1542,1693238715601,1692266451535,1692266451703,1693238715822,221,168,53
1543,1693238715822,1692266451739,1692266451901,1693238716095,273,162,111
1544,1693238716095,1692266452167,1692266452331,1693238716459,364,164,200
1545,1693238716459,1692266452414,1692266452580,1693238716699,240,166,74
1546,1693238716699,1692266452641,1692266452805,1693238716926,227,164,63
1547,1693238716926,1692266452853,1692266453016,1693238717135,209,163,46
1548,1693238717135,1692266453089,1692266453252,1693238717372,237,163,74
1549,1693238717372,1692266453295,1692266453457,1693238717577,205,162,43
1550,1693238717577,1692266453500,1692266453661,1693238717781,204,161,43
1551,1693238717781,1692266453692,1692266453855,1693238717974,193,163,30
1552,1693238717974,1692266453895,1692266454058,1693238718177,203,163,40
1553,1693238718178,1692266454095,1692266454258,1693238718377,199,163,36
1554,1693238718377,1692266454321,1692266454484,1693238718604,227,163,64
1555,1693238718604,1692266454539,1692266454703,1693238718823,219,164,55
1556,1693238718823,1692266454739,1692266454902,1693238719022,199,163,36
1557,1693238719022,1692266454946,1692266455108,1693238719233,211,162,49
1558,1693238719233,1692266455156,1692266455319,1693238719438,205,163,42
1559,1693238719438,1692266455354,1692266455515,1693238719635,197,161,36
1560,1693238719635,1692266455584,1692266455748,1693238719868,233,164,69
1561,1693238719868,1692266455801,1692266455965,1693238720085,217,164,53
1562,1693238720085,1692266456021,1692266456184,1693238720304,219,163,56
1563,1693238720304,1692266456222,1692266456386,1693238720505,201,164,37
1564,1693238720506,1692266456433,1692266456595,1693238720715,209,162,47
1565,1693238720715,1692266456643,1692266456806,1693238720926,211,163,48
1566,1693238720926,1692266456843,1692266457005,1693238721124,198,162,36
1567,1693238721124,1692266457050,1692266457214,1693238721333,209,164,45
1568,1693238721334,1692266457259,1692266457421,1693238721541,207,162,45
1569,1693238721541,1692266457482,1692266457645,1693238721765,224,163,61
1570,1693238721765,1692266457690,1692266457853,1693238721972,207,163,44
1571,1693238721972,1692266457905,1692266458068,1693238722188,216,163,53
1572,1693238722188,1692266458123,1692266458287,1693238722406,218,164,54
1573,1693238722406,1692266458325,1692266458489,1693238722609,203,164,39
1574,1693238722609,1692266458520,1692266458683,1693238722802,193,163,30
1575,1693238722802,1692266458729,1692266458892,1693238723011,209,163,46
1576,1693238723011,1692266458920,1692266459083,1693238723202,191,163,28
1577,1693238723202,1692266459115,1692266459279,1693238723398,196,164,32
1578,1693238723398,1692266459323,1692266459485,1693238723605,207,162,45
1579,1693238723605,1692266459525,1692266459688,1693238723808,203,163,40
1580,1693238723808,1692266459727,1692266459889,1693238724009,201,162,39
1581,1693238724009,1692266459944,1692266460109,1693238724229,220,165,55
1582,1693238724229,1692266460151,1692266460314,1693238724447,218,163,55
1583,1693238724447,1692266460365,1692266460527,1693238724647,200,162,38
1584,1693238724647,1692266460603,1692266460767,1693238724887,240,164,76
1585,1693238724887,1692266460826,1692266460989,1693238725108,221,163,58
1586,1693238725109,1692266461040,1692266461202,1693238725321,212,162,50
1587,1693238725321,1692266461247,1692266461410,1693238725530,209,163,46
1588,1693238725530,1692266461469,1692266461632,1693238725751,221,163,58
1589,1693238725751,1692266461679,1692266461844,1693238725964,213,165,48
1590,1693238725964,1692266461914,1692266462078,1693238726198,234,164,70
1591,1693238726198,1692266462093,1692266462255,1693238726374,176,162,14
1592,1693238726375,1692266462309,1692266462472,1693238726591,216,163,53
1593,1693238726591,1692266462561,1692266462725,1693238726845,254,164,90
1594,1693238726845,1692266462804,1692266462967,1693238727087,242,163,79
1595,1693238727087,1692266463034,1692266463198,1693238727318,231,164,67
1596,1693238727318,1692266463246,1692266463408,1693238727528,210,162,48
1597,1693238727528,1692266463456,1692266463619,1693238727739,211,163,48
1598,1693238727739,1692266463658,1692266463819,1693238727939,200,161,39
1599,1693238727939,1692266463870,1692266464033,1693238728153,214,163,51
1600,1693238728153,1692266464079,1692266464241,1693238728360,207,162,45
1601,1693238728360,1692266464281,1692266464445,1693238728564,204,164,40
1602,1693238728564,1692266464513,1692266464676,1693238728796,232,163,69
1603,1693238728796,1692266464713,1692266464877,1693238728996,200,164,36
1604,1693238728996,1692266464932,1692266465094,1693238729214,218,162,56
1605,1693238729214,1692266465108,1692266465268,1693238729388,174,160,14
1606,1693238729388,1692266465343,1692266465513,1693238729632,244,170,74
1607,1693238729632,1692266465556,1692266465719,1693238729838,206,163,43
1608,1693238729838,1692266465784,1692266465947,1693238730067,229,163,66
1609,1693238730067,1692266466012,1692266466175,1693238730295,228,163,65
1610,1693238730295,1692266466225,1692266466388,1693238730508,213,163,50
1611,1693238730508,1692266466434,1692266466598,1693238730719,211,164,47
1612,1693238730719,1692266466634,1692266466796,1693238730916,197,162,35
1613,1693238730916,1692266466850,1692266467014,1693238731134,218,164,54
1614,1693238731134,1692266467055,1692266467217,1693238731336,202,162,40
1615,1693238731336,1692266467266,1692266467428,1693238731548,212,162,50
1616,1693238731548,1692266467540,1692266467702,1693238731821,273,162,111
1617,1693238731821,1692266467818,1692266467981,1693238732100,279,163,116
1618,1693238732100,1692266468028,1692266468190,1693238732309,209,162,47
1619,1693238732309,1692266468258,1692266468420,1693238732540,231,162,69
1620,1693238732540,1692266468510,1692266468673,1693238732793,253,163,90
1621,1693238732793,1692266468716,1692266468878,1693238732997,204,162,42
1622,1693238732997,1692266468922,1692266469085,1693238733204,207,163,44
1623,1693238733204,1692266469140,1692266469304,1693238733423,219,164,55
1624,1693238733423,1692266469366,1692266469529,1693238733649,226,163,63
1625,1693238733649,1692266469582,1692266469746,1693238733866,217,164,53
1626,1693238733866,1692266469784,1692266469947,1693238734066,200,163,37
1627,1693238734066,1692266469995,1692266470158,1693238734277,211,163,48
1628,1693238734277,1692266470222,1692266470386,1693238734508,231,164,67
1629,1693238734508,1692266470433,1692266470596,1693238734715,207,163,44
1630,1693238734715,1692266470642,1692266470805,1693238734924,209,163,46
1631,1693238734924,1692266470842,1692266471005,1693238735125,201,163,38
1632,1693238735125,1692266471043,1692266471204,1693238735324,199,161,38
1633,1693238735324,1692266471247,1692266471411,1693238735532,208,164,44
1634,1693238735532,1692266471451,1692266471612,1693238735732,200,161,39
1635,1693238735732,1692266471660,1692266471823,1693238735943,211,163,48
1636,1693238735943,1692266471872,1692266472034,1693238736154,211,162,49
1637,1693238736154,1692266472070,1692266472232,1693238736351,197,162,35
1638,1693238736351,1692266472243,1692266472405,1693238736525,174,162,12
1639,1693238736525,1692266472451,1692266472613,1693238736732,207,162,45
1640,1693238736732,1692266472678,1692266472842,1693238736962,230,164,66
1641,1693238737124,1692266473077,1692266473351,1693238737471,347,274,73
1642,1693238737471,1692266473413,1692266473610,1693238737730,259,197,62
1643,1693238737730,1692266473667,1692266473853,1693238737973,243,186,57
1644,1693238737973,1692266473970,1692266474173,1693238738399,426,203,223
1645,1693238738399,1692266474335,1692266474518,1693238738709,310,183,127
1646,1693238738709,1692266474633,1692266474836,1693238738956,247,203,44
1647,1693238738956,1692266474903,1692266475110,1693238739322,366,207,159
1648,1693238739322,1692266475275,1692266475477,1693238739597,275,202,73
1649,1693238739597,1692266475552,1692266475752,1693238739939,342,200,142
1650,1693238739939,1692266475874,1692266476086,1693238740246,307,212,95
1651,1693238740246,1692266476197,1692266476410,1693238740553,307,213,94
1652,1693238740553,1692266476476,1692266476689,1693238740808,255,213,42
1653,1693238740809,1692266476727,1692266476946,1693238741171,362,219,143
1654,1693238741171,1692266477087,1692266477274,1693238741394,223,187,36
1655,1693238741394,1692266477300,1692266477507,1693238741627,233,207,26
1656,1693238741627,1692266477570,1692266477782,1693238741986,359,212,147
1657,1693238741986,1692266477904,1692266478090,1693238742213,227,186,41
1658,1693238742213,1692266478136,1692266478329,1693238742449,236,193,43
1659,1693238742449,1692266478367,1692266478586,1693238742706,257,219,38
1660,1693238742706,1692266478634,1692266478830,1693238742950,244,196,48
1661,1693238742950,1692266478874,1692266479060,1693238743180,230,186,44
1662,1693238743180,1692266479118,1692266479316,1693238743436,256,198,58
1663,1693238743436,1692266479359,1692266479560,1693238743682,246,201,45
1664,1693238743682,1692266479612,1692266479805,1693238743925,243,193,50
1665,1693238743925,1692266479848,1692266480046,1693238744166,241,198,43
1666,1693238744166,1692266480103,1692266480311,1693238744444,278,208,70
1667,1693238744444,1692266480374,1692266480602,1693238744723,279,228,51
1668,1693238744723,1692266480639,1692266480835,1693238745062,339,196,143
1669,1693238745063,1692266481003,1692266481214,1693238745335,272,211,61
1670,1693238745335,1692266481295,1692266481494,1693238745613,278,199,79
1671,1693238745613,1692266481514,1692266481698,1693238745818,205,184,21
1672,1693238745818,1692266481766,1692266481957,1693238746081,263,191,72
1673,1693238746081,1692266482023,1692266482234,1693238746387,306,211,95
1674,1693238746387,1692266482331,1692266482547,1693238746696,309,216,93
1675,1693238746696,1692266482619,1692266482821,1693238746942,246,202,44
1676,1693238746942,1692266482875,1692266483082,1693238747202,260,207,53
1677,1693238747202,1692266483157,1692266483378,1693238747504,302,221,81
1678,1693238747505,1692266483432,1692266483643,1693238747763,258,211,47
1679,1693238747763,1692266483708,1692266483935,1693238748055,292,227,65
1680,1693238748055,1692266483998,1692266484195,1693238748315,260,197,63
1681,1693238748315,1692266484255,1692266484461,1693238748581,266,206,60
1682,1693238748581,1692266484513,1692266484725,1693238748844,263,212,51
1683,1693238748844,1692266484774,1692266484983,1693238749112,268,209,59
1684,1693238749112,1692266485149,1692266485358,1693238749477,365,209,156
1685,1693238749477,1692266485407,1692266485585,1693238749719,242,178,64
1686,1693238749719,1692266485679,1692266485857,1693238749976,257,178,79
1687,1693238749977,1692266485924,1692266486112,1693238750234,257,188,69
1688,1693238750234,1692266486157,1692266486380,1693238750500,266,223,43
1689,1693238750500,1692266486418,1692266486676,1693238750797,297,258,39
1690,1693238750797,1692266486719,1692266486916,1693238751035,238,197,41
1691,1693238751035,1692266486956,1692266487146,1693238751270,235,190,45
1692,1693238751270,1692266487217,1692266487399,1693238751518,248,182,66
1693,1693238751518,1692266487431,1692266487623,1693238751742,224,192,32
1694,1693238751742,1692266487649,1692266487840,1693238751959,217,191,26
1695,1693238751959,1692266487907,1692266488101,1693238752222,263,194,69
1696,1693238752222,1692266488134,1692266488325,1693238752447,225,191,34
1697,1693238752447,1692266488395,1692266488611,1693238752730,283,216,67
1698,1693238752730,1692266488669,1692266488862,1693238752983,253,193,60
1699,1693238752983,1692266488909,1692266489092,1693238753213,230,183,47
1700,1693238753213,1692266489148,1692266489345,1693238753465,252,197,55
1701,1693238753465,1692266489381,1692266489584,1693238753704,239,203,36
1702,1693238753704,1692266489626,1692266489810,1693238753929,225,184,41
1703,1693238753929,1692266489853,1692266490039,1693238754158,229,186,43
1704,1693238754158,1692266490077,1692266490256,1693238754378,220,179,41
1705,1693238754378,1692266490314,1692266490499,1693238754621,243,185,58
1706,1693238754621,1692266490562,1692266490745,1693238754864,243,183,60
1707,1693238754864,1692266490794,1692266490978,1693238755097,233,184,49
1708,1693238755097,1692266491017,1692266491223,1693238755400,303,206,97
1709,1693238755401,1692266491350,1692266491536,1693238755656,255,186,69
1710,1693238755656,1692266491590,1692266491773,1693238755892,236,183,53
1711,1693238755892,1692266491856,1692266492042,1693238756162,270,186,84
1712,1693238756162,1692266492103,1692266492291,1693238756411,249,188,61
1713,1693238756411,1692266492337,1692266492523,1693238756643,232,186,46
1714,1693238756643,1692266492558,1692266492743,1693238756863,220,185,35
1715,1693238756863,1692266492799,1692266493026,1693238757244,381,227,154
1716,1693238757244,1692266493215,1692266493449,1693238757569,325,234,91
1717,1693238757569,1692266493513,1692266493708,1693238757828,259,195,64
1718,1693238757828,1692266493777,1692266493991,1693238758110,282,214,68
1719,1693238758110,1692266494032,1692266494236,1693238758355,245,204,41
1720,1693238758355,1692266494289,1692266494474,1693238758594,239,185,54
1721,1693238758594,1692266494510,1692266494699,1693238758819,225,189,36
1722,1693238758819,1692266494788,1692266495003,1693238759190,371,215,156
1723,1693238759190,1692266495111,1692266495323,1693238759498,308,212,96
1724,1693238759498,1692266495428,1692266495654,1693238759775,277,226,51
1725,1693238759775,1692266495700,1692266495980,1693238760104,329,280,49
1726,1693238760104,1692266496024,1692266496242,1693238760362,258,218,40
1727,1693238760363,1692266496286,1692266496477,1693238760596,233,191,42
1728,1693238760596,1692266496494,1692266496730,1693238760853,257,236,21
1729,1693238760853,1692266496766,1692266497033,1693238761185,332,267,65
1730,1693238761185,1692266497102,1692266497302,1693238761422,237,200,37
1731,1693238761422,1692266497380,1692266497572,1693238761692,270,192,78
1732,1693238761692,1692266497622,1692266497832,1693238761952,260,210,50
1733,1693238761952,1692266497862,1692266498091,1693238762211,259,229,30
1734,1693238762212,1692266498136,1692266498347,1693238762467,255,211,44
1735,1693238762467,1692266498384,1692266498594,1693238762714,247,210,37
1736,1693238762714,1692266498667,1692266498857,1693238762977,263,190,73
1737,1693238762977,1692266498913,1692266499139,1693238763286,309,226,83
1738,1693238763286,1692266499214,1692266499410,1693238763529,243,196,47
1739,1693238763529,1692266499453,1692266499646,1693238763765,236,193,43
1740,1693238763765,1692266499693,1692266499904,1693238764072,307,211,96
1741,1693238764072,1692266500024,1692266500240,1693238764417,345,216,129
1742,1693238764417,1692266500368,1692266500609,1693238764729,312,241,71
1743,1693238764729,1692266500660,1692266500880,1693238765000,271,220,51
1744,1693238765000,1692266500947,1692266501140,1693238765267,267,193,74
1745,1693238765267,1692266501213,1692266501390,1693238765510,243,177,66
1746,1693238765510,1692266501488,1692266501669,1693238765790,280,181,99
1747,1693238765790,1692266501719,1692266501907,1693238766027,237,188,49
1748,1693238766027,1692266501966,1692266502181,1693238766300,273,215,58
1749,1693238766300,1692266502220,1692266502436,1693238766556,256,216,40
1750,1693238766556,1692266502497,1692266502708,1693238766831,275,211,64
1751,1693238766831,1692266502766,1692266502967,1693238767086,255,201,54
1752,1693238767086,1692266503016,1692266503181,1693238767301,215,165,50
1753,1693238767312,1692266503250,1692266503413,1693238767533,221,163,58
1754,1693238767533,1692266503484,1692266503648,1693238767768,235,164,71
1755,1693238767768,1692266503692,1692266503855,1693238767974,206,163,43
1756,1693238767974,1692266503905,1692266504071,1693238768190,216,166,50
1757,1693238768190,1692266504135,1692266504299,1693238768420,230,164,66
1758,1693238768420,1692266504371,1692266504535,1693238768654,234,164,70
1759,1693238768654,1692266504613,1692266504778,1693238768897,243,165,78
1760,1693238768897,1692266504877,1692266505039,1693238769158,261,162,99
1761,1693238769158,1692266505109,1692266505274,1693238769393,235,165,70
1762,1693238769393,1692266505332,1692266505494,1693238769613,220,162,58
1763,1693238769613,1692266505536,1692266505699,1693238769818,205,163,42
1764,1693238769818,1692266505737,1692266505899,1693238770018,200,162,38
1765,1693238770018,1692266505954,1692266506117,1693238770236,218,163,55
1766,1693238770236,1692266506152,1692266506313,1693238770432,196,161,35
1767,1693238770432,1692266506355,1692266506517,1693238770636,204,162,42
1768,1693238770636,1692266506575,1692266506740,1693238770859,223,165,58
1769,1693238770859,1692266506796,1692266506960,1693238771079,220,164,56
1770,1693238771079,1692266507000,1692266507163,1693238771282,203,163,40
1771,1693238771282,1692266507211,1692266507376,1693238771495,213,165,48
1772,1693238771496,1692266507420,1692266507584,1693238771703,207,164,43
1773,1693238771703,1692266507627,1692266507789,1693238771908,205,162,43
1774,1693238771908,1692266507838,1692266508001,1693238772119,211,163,48
1775,1693238772120,1692266508061,1692266508224,1693238772343,223,163,60
1776,1693238772343,1692266508277,1692266508439,1693238772558,215,162,53
1777,1693238772558,1692266508482,1692266508644,1693238772763,205,162,43
1778,1693238772763,1692266508715,1692266508880,1693238773000,237,165,72
1779,1693238773000,1692266508923,1692266509088,1693238773207,207,165,42
1780,1693238773207,1692266509122,1692266509284,1693238773403,196,162,34
1781,1693238773403,1692266509338,1692266509501,1693238773620,217,163,54
1782,1693238773620,1692266509540,1692266509702,1693238773821,201,162,39
1783,1693238773821,1692266509741,1692266509902,1693238774021,200,161,39
1784,1693238774021,1692266509974,1692266510140,1693238774259,238,166,72
1785,1693238774259,1692266510179,1692266510341,1693238774460,201,162,39
1786,1693238774460,1692266510405,1692266510568,1693238774687,227,163,64
1787,1693238774687,1692266510632,1692266510795,1693238774914,227,163,64
1788,1693238774914,1692266510850,1692266511013,1693238775132,218,163,55
1789,1693238775132,1692266511043,1692266511205,1693238775324,192,162,30
1790,1693238775324,1692266511255,1692266511419,1693238775543,219,164,55
1791,1693238775543,1692266511482,1692266511645,1693238775764,221,163,58
1792,1693238775764,1692266511709,1692266511874,1693238775993,229,165,64
1793,1693238775993,1692266511905,1692266512067,1693238776186,193,162,31
1794,1693238776186,1692266512098,1692266512262,1693238776381,195,164,31
1795,1693238776381,1692266512323,1692266512487,1693238776606,225,164,61
1796,1693238776606,1692266512532,1692266512695,1693238776817,211,163,48
1797,1693238776817,1692266512753,1692266512915,1693238777034,217,162,55
1798,1693238777034,1692266512958,1692266513120,1693238777239,205,162,43
1799,1693238777239,1692266513167,1692266513330,1693238777450,211,163,48
1800,1693238777450,1692266513409,1692266513574,1693238777695,245,165,80
1801,1693238777695,1692266513607,1692266513769,1693238777888,193,162,31
1802,1693238777888,1692266513818,1692266513980,1693238778099,211,162,49
1803,1693238778099,1692266514042,1692266514204,1693238778323,224,162,62
1804,1693238778323,1692266514247,1692266514409,1693238778528,205,162,43
1805,1693238778528,1692266514468,1692266514631,1693238778750,222,163,59
1806,1693238778750,1692266514670,1692266514832,1693238778952,202,162,40
1807,1693238778952,1692266514894,1692266515058,1693238779179,227,164,63
1808,1693238779179,1692266515118,1692266515281,1693238779400,221,163,58
1809,1693238779400,1692266515334,1692266515498,1693238779692,292,164,128
1810,1693238779692,1692266515692,1692266515854,1693238779973,281,162,119
1811,1693238779974,1692266515903,1692266516066,1693238780186,212,163,49
1812,1693238780186,1692266516109,1692266516271,1693238780389,203,162,41
1813,1693238780390,1692266516308,1692266516471,1693238780591,201,163,38
1814,1693238780591,1692266516508,1692266516670,1693238780788,197,162,35
1815,1693238780788,1692266516706,1692266516867,1693238780986,198,161,37
1816,1693238780986,1692266516932,1692266517095,1693238781214,228,163,65
1817,1693238781214,1692266517129,1692266517292,1693238781411,197,163,34
1818,1693238781411,1692266517326,1692266517487,1693238781606,195,161,34
1819,1693238781606,1692266517513,1692266517675,1693238781794,188,162,26
1820,1693238781794,1692266517719,1692266517881,1693238782000,206,162,44
1821,1693238782000,1692266517923,1692266518087,1693238782206,206,164,42
1822,1693238782206,1692266518106,1692266518267,1693238782386,180,161,19
1823,1693238782386,1692266518328,1692266518491,1693238782610,224,163,61
1824,1693238782610,1692266518537,1692266518699,1693238782818,208,162,46
1825,1693238782818,1692266518743,1692266518905,1693238783024,206,162,44
1826,1693238783024,1692266518953,1692266519116,1693238783235,211,163,48
1827,1693238783235,1692266519184,1692266519349,1693238783468,233,165,68
1828,1693238783468,1692266519396,1692266519559,1693238783678,210,163,47
1829,1693238783678,1692266519594,1692266519757,1693238783876,198,163,35
1830,1693238783876,1692266519815,1692266519980,1693238784099,223,165,58
1831,1693238784099,1692266520022,1692266520187,1693238784307,208,165,43
1832,1693238784307,1692266520244,1692266520407,1693238784526,219,163,56
1833,1693238784526,1692266520456,1692266520618,1693238784737,211,162,49
1834,1693238784737,1692266520674,1692266520838,1693238784957,220,164,56
1835,1693238784957,1692266520872,1692266521036,1693238785156,199,164,35
1836,1693238785156,1692266521105,1692266521268,1693238785387,231,163,68
1837,1693238785387,1692266521295,1692266521458,1693238785576,189,163,26
1838,1693238785576,1692266521484,1692266521645,1693238785764,188,161,27
1839,1693238785764,1692266521705,1692266521868,1693238785987,223,163,60
1840,1693238785988,1692266521903,1692266522066,1693238786184,196,163,33
1841,1693238786185,1692266522099,1692266522262,1693238786381,196,163,33
1842,1693238786381,1692266522302,1692266522466,1693238786585,204,164,40
1843,1693238786585,1692266522505,1692266522668,1693238786788,203,163,40
1844,1693238786788,1692266522705,1692266522867,1693238786986,198,162,36
1845,1693238786986,1692266522915,1692266523077,1693238787196,210,162,48
1846,1693238787196,1692266523144,1692266523307,1693238787426,230,163,67
1847,1693238787426,1692266523356,1692266523519,1693238787638,212,163,49
1848,1693238787638,1692266523555,1692266523717,1693238787836,198,162,36
1849,1693238787836,1692266523769,1692266523934,1693238788053,217,165,52
1850,1693238788053,1692266523983,1692266524147,1693238788267,214,164,50
1851,1693238788267,1692266524177,1692266524340,1693238788458,191,163,28
1852,1693238788458,1692266524374,1692266524536,1693238788655,197,162,35
1853,1693238788655,1692266524578,1692266524740,1693238788859,204,162,42
1854,1693238788859,1692266524794,1692266524957,1693238789076,217,163,54
1855,1693238789076,1692266524986,1692266525149,1693238789268,192,163,29
1856,1693238789268,1692266525191,1692266525354,1693238789473,205,163,42
1857,1693238789473,1692266525405,1692266525568,1693238789687,214,163,51
1858,1693238789687,1692266525600,1692266525762,1693238789881,194,162,32
1859,1693238789881,1692266525795,1692266525956,1693238790075,194,161,33
1860,1693238790075,1692266526021,1692266526185,1693238790304,229,164,65
1861,1693238790304,1692266526227,1692266526390,1693238790509,205,163,42
1862,1693238790509,1692266526432,1692266526596,1693238790715,206,164,42
1863,1693238790715,1692266526626,1692266526787,1693238790906,191,161,30
1864,1693238790906,1692266526857,1692266527021,1693238791140,234,164,70
1865,1693238791140,1692266527078,1692266527241,1693238791361,221,163,58
1866,1693238791361,1692266527296,1692266527459,1693238791577,216,163,53
1867,1693238791577,1692266527535,1692266527701,1693238791820,243,166,77
1868,1693238791820,1692266527745,1692266527908,1693238792026,206,163,43
1869,1693238792026,1692266527938,1692266528099,1693238792218,192,161,31
1870,1693238792218,1692266528142,1692266528304,1693238792423,205,162,43
1871,1693238792423,1692266528355,1692266528520,1693238792640,217,165,52
1872,1693238792640,1692266528551,1692266528713,1693238792831,191,162,29
1873,1693238792831,1692266528764,1692266528929,1693238793047,216,165,51
1874,1693238793047,1692266528978,1692266529141,1693238793260,213,163,50
1875,1693238793260,1692266529188,1692266529352,1693238793470,210,164,46
1876,1693238793470,1692266529399,1692266529561,1693238793680,210,162,48
1877,1693238793680,1692266529601,1692266529763,1693238793882,202,162,40
1878,1693238793882,1692266529797,1692266529958,1693238794076,194,161,33
1879,1693238794076,1692266530019,1692266530182,1693238794302,226,163,63
1880,1693238794302,1692266530205,1692266530367,1693238794486,184,162,22
1881,1693238794486,1692266530412,1692266530577,1693238794695,209,165,44
1882,1693238794695,1692266530612,1692266530774,1693238794893,198,162,36
1883,1693238794893,1692266530812,1692266530974,1693238795092,199,162,37
1884,1693238795092,1692266531026,1692266531190,1693238795308,216,164,52
1885,1693238795308,1692266531221,1692266531383,1693238795502,194,162,32
1886,1693238795502,1692266531445,1692266531608,1693238795727,225,163,62
1887,1693238795727,1692266531651,1692266531814,1693238795933,206,163,43
1888,1693238795933,1692266531853,1692266532015,1693238796134,201,162,39
1889,1693238796134,1692266532034,1692266532196,1693238796315,181,162,19
1890,1693238796315,1692266532247,1692266532409,1693238796528,213,162,51
1891,1693238796528,1692266532464,1692266532630,1693238796749,221,166,55
1892,1693238796749,1692266532684,1692266532846,1693238796965,216,162,54
1893,1693238796965,1692266532887,1692266533052,1693238797170,205,165,40
1894,1693238797170,1692266533088,1692266533250,1693238797369,199,162,37
1895,1693238797531,1692266533468,1692266533706,1693238797825,294,238,56
1896,1693238797825,1692266533741,1692266533950,1693238798070,245,209,36
1897,1693238798070,1692266533988,1692266534183,1693238798302,232,195,37
1898,1693238798302,1692266534225,1692266534432,1693238798613,311,207,104
1899,1693238798613,1692266534550,1692266534766,1693238798885,272,216,56
1900,1693238798885,1692266534812,1692266535004,1693238799167,282,192,90
1901,1693238799167,1692266535084,1692266535288,1693238799408,241,204,37
1902,1693238799408,1692266535366,1692266535562,1693238799681,273,196,77
1903,1693238799681,1692266535606,1692266535796,1693238799915,234,190,44
1904,1693238799915,1692266535855,1692266536058,1693238800177,262,203,59
1905,1693238800177,1692266536112,1692266536303,1693238800422,245,191,54
1906,1693238800422,1692266536365,1692266536555,1693238800674,252,190,62
1907,1693238800674,1692266536596,1692266536782,1693238800901,227,186,41
1908,1693238800901,1692266536843,1692266537039,1693238801158,257,196,61
1909,1693238801158,1692266537082,1692266537281,1693238801400,242,199,43
1910,1693238801400,1692266537325,1692266537515,1693238801633,233,190,43
1911,1693238801634,1692266537552,1692266537753,1693238801872,238,201,37
1912,1693238801872,1692266537806,1692266538023,1693238802143,271,217,54
1913,1693238802143,1692266538102,1692266538293,1693238802412,269,191,78
1914,1693238802412,1692266538329,1692266538515,1693238802634,222,186,36
1915,1693238802634,1692266538552,1692266538739,1693238802858,224,187,37
1916,1693238802858,1692266538779,1692266538997,1693238803142,284,218,66
1917,1693238803142,1692266539064,1692266539267,1693238803386,244,203,41
1918,1693238803386,1692266539329,1692266539544,1693238803663,277,215,62
1919,1693238803663,1692266539608,1692266539794,1693238803913,250,186,64
1920,1693238803913,1692266539849,1692266540030,1693238804149,236,181,55
1921,1693238804149,1692266540083,1692266540266,1693238804385,236,183,53
1922,1693238804385,1692266540336,1692266540524,1693238804643,258,188,70
1923,1693238804643,1692266540552,1692266540750,1693238804869,226,198,28
1924,1693238804869,1692266540790,1692266541001,1693238805120,251,211,40
1925,1693238805120,1692266541030,1692266541213,1693238805332,212,183,29
1926,1693238805332,1692266541258,1692266541433,1693238805552,220,175,45
1927,1693238805552,1692266541467,1692266541652,1693238805772,220,185,35
1928,1693238805772,1692266541721,1692266541925,1693238806046,274,204,70
1929,1693238806046,1692266541986,1692266542183,1693238806302,256,197,59
1930,1693238806302,1692266542210,1692266542397,1693238806516,214,187,27
1931,1693238806516,1692266542460,1692266542658,1693238806778,262,198,64
1932,1693238806778,1692266542705,1692266542922,1693238807045,267,217,50
1933,1693238807045,1692266542984,1692266543206,1693238807325,280,222,58
1934,1693238807325,1692266543255,1692266543462,1693238807581,256,207,49
1935,1693238807581,1692266543514,1692266543704,1693238807825,244,190,54
1936,1693238807825,1692266543755,1692266543945,1693238808064,239,190,49
1937,1693238808064,1692266543993,1692266544184,1693238808302,238,191,47
1938,1693238808303,1692266544233,1692266544419,1693238808538,235,186,49
1939,1693238808538,1692266544485,1692266544682,1693238808801,263,197,66
1940,1693238808801,1692266544730,1692266544955,1693238809074,273,225,48
1941,1693238809074,1692266545016,1692266545240,1693238809407,333,224,109
1942,1693238809407,1692266545317,1692266545516,1693238809749,342,199,143
1943,1693238809750,1692266545716,1692266545923,1693238810081,331,207,124
1944,1693238810081,1692266546036,1692266546221,1693238810389,308,185,123
1945,1693238810389,1692266546322,1692266546511,1693238810630,241,189,52
1946,1693238810630,1692266546577,1692266546770,1693238810893,263,193,70
1947,1693238810893,1692266546828,1692266547035,1693238811154,261,207,54
1948,1693238811154,1692266547079,1692266547282,1693238811403,249,203,46
1949,1693238811403,1692266547315,1692266547504,1693238811624,221,189,32
1950,1693238811624,1692266547548,1692266547777,1693238811899,275,229,46
1951,1693238811899,1692266547831,1692266548029,1693238812148,249,198,51
1952,1693238812148,1692266548066,1692266548294,1693238812414,266,228,38
1953,1693238812414,1692266548344,1692266548554,1693238812672,258,210,48
1954,1693238812673,1692266548589,1692266548767,1693238812886,213,178,35
1955,1693238812886,1692266548828,1692266549009,1693238813128,242,181,61
1956,1693238813128,1692266549068,1692266549268,1693238813387,259,200,59
1957,1693238813387,1692266549299,1692266549501,1693238813620,233,202,31
1958,1693238813620,1692266549541,1692266549722,1693238813841,221,181,40
1959,1693238813841,1692266549774,1692266549954,1693238814073,232,180,52
1960,1693238814073,1692266549976,1692266550156,1693238814276,203,180,23
1961,1693238814276,1692266550210,1692266550389,1693238814508,232,179,53
1962,1693238814508,1692266550427,1692266550604,1693238814723,215,177,38
1963,1693238814723,1692266550640,1692266550816,1693238814935,212,176,36
1964,1693238814935,1692266550860,1692266551042,1693238815163,228,182,46
1965,1693238815163,1692266551080,1692266551275,1693238815394,231,195,36
1966,1693238815394,1692266551316,1692266551520,1693238815639,245,204,41
1967,1693238815639,1692266551560,1692266551763,1693238815882,243,203,40
1968,1693238815882,1692266551810,1692266552018,1693238816157,275,208,67
1969,1693238816157,1692266552090,1692266552301,1693238816420,263,211,52
1970,1693238816420,1692266552336,1692266552537,1693238816656,236,201,35
1971,1693238816656,1692266552597,1692266552811,1693238816931,275,214,61
1972,1693238816931,1692266552834,1692266553022,1693238817143,212,188,24
1973,1693238817143,1692266553113,1692266553297,1693238817416,273,184,89
1974,1693238817416,1692266553356,1692266553536,1693238817658,242,180,62
1975,1693238817658,1692266553596,1692266553775,1693238817893,235,179,56
1976,1693238817893,1692266553815,1692266554001,1693238818120,227,186,41
1977,1693238818120,1692266554065,1692266554271,1693238818478,358,206,152
1978,1693238818478,1692266554401,1692266554596,1693238818715,237,195,42
1979,1693238818715,1692266554644,1692266554828,1693238818947,232,184,48
1980,1693238818947,1692266554859,1692266555049,1693238819168,221,190,31
1981,1693238819168,1692266555100,1692266555303,1693238819490,322,203,119
1982,1693238819490,1692266555418,1692266555607,1693238819726,236,189,47
1983,1693238819726,1692266555657,1692266555844,1693238819962,236,187,49
1984,1693238819963,1692266555864,1692266556041,1693238820159,196,177,19
1985,1693238820159,1692266556102,1692266556283,1693238820402,243,181,62
1986,1693238820402,1692266556322,1692266556509,1693238820629,227,187,40
1987,1693238820629,1692266556544,1692266556754,1693238820873,244,210,34
1988,1693238820873,1692266556805,1692266556990,1693238821110,237,185,52
1989,1693238821111,1692266557024,1692266557236,1693238821447,336,212,124
1990,1693238821447,1692266557377,1692266557571,1693238821689,242,194,48
1991,1693238821689,1692266557615,1692266557802,1693238821921,232,187,45
1992,1693238821921,1692266557856,1692266558042,1693238822161,240,186,54
1993,1693238822161,1692266558082,1692266558254,1693238822373,212,172,40
1994,1693238822373,1692266558289,1692266558466,1693238822584,211,177,34
1995,1693238822584,1692266558507,1692266558684,1693238822802,218,177,41
1996,1693238822802,1692266558739,1692266558929,1693238823048,246,190,56
1997,1693238823048,1692266558966,1692266559165,1693238823287,239,199,40
1998,1693238823287,1692266559206,1692266559414,1693238823532,245,208,37
1999,1693238823533,1692266559468,1692266559680,1693238823799,266,212,54
2000,1693238823799,1692266559727,1692266559930,1693238824114,315,203,112
2001,1693238824114,1692266560055,1692266560240,1693238824359,245,185,60
2002,1693238824359,1692266560302,1692266560491,1693238824609,250,189,61
2003,1693238824610,1692266560523,1692266560721,1693238824853,243,198,45
2004,1693238824853,1692266560760,1692266560962,1693238825081,228,202,26
2005,1693238825081,1692266561012,1692266561205,1693238825324,243,193,50
2006,1693238825324,1692266561244,1692266561422,1693238825541,217,178,39
2007,1693238825541,1692266561455,1692266561642,1693238825761,220,187,33
2008,1693238825761,1692266561662,1692266561860,1693238825983,222,198,24
2009,1693238825983,1692266561901,1692266562116,1693238826261,278,215,63
2010,1693238826261,1692266562191,1692266562406,1693238826525,264,215,49
2011,1693238826525,1692266562451,1692266562667,1693238826794,269,216,53
2012,1693238826794,1692266562736,1692266562960,1693238827079,285,224,61
2013,1693238827079,1692266562989,1692266563188,1693238827308,229,199,30
2014,1693238827308,1692266563251,1692266563432,1693238827550,242,181,61
2015,1693238827558,1692266563468,1692266563629,1693238827748,190,161,29
2016,1693238827748,1692266563659,1692266563822,1693238827940,192,163,29
2017,1693238827940,1692266563844,1692266564005,1693238828124,184,161,23
2018,1693238828124,1692266564068,1692266564231,1693238828350,226,163,63
2019,1693238828350,1692266564283,1692266564446,1693238828566,216,163,53
2020,1693238828566,1692266564507,1692266564670,1693238828788,222,163,59
2021,1693238828788,1692266564694,1692266564858,1693238828976,188,164,24
2022,1693238828976,1692266564903,1692266565066,1693238829184,208,163,45
2023,1693238829184,1692266565141,1692266565305,1693238829424,240,164,76
2024,1693238829424,1692266565348,1692266565511,1693238829629,205,163,42
2025,1693238829629,1692266565546,1692266565709,1693238829827,198,163,35
2026,1693238829827,1692266565756,1692266565922,1693238830041,214,166,48
2027,1693238830041,1692266565960,1692266566122,1693238830240,199,162,37
2028,1693238830241,1692266566156,1692266566318,1693238830437,196,162,34
2029,1693238830438,1692266566368,1692266566532,1693238830651,213,164,49
2030,1693238830651,1692266566589,1692266566752,1693238830871,220,163,57
2031,1693238830871,1692266566783,1692266566946,1693238831064,193,163,30
2032,1693238831064,1692266566985,1692266567147,1693238831265,201,162,39
2033,1693238831265,1692266567186,1692266567347,1693238831466,201,161,40
2034,1693238831466,1692266567390,1692266567555,1693238831673,207,165,42
2035,1693238831673,1692266567582,1692266567745,1693238831863,190,163,27
2036,1693238831863,1692266567782,1692266567945,1693238832063,200,163,37
2037,1693238832063,1692266567996,1692266568161,1693238832280,217,165,52
2038,1693238832280,1692266568209,1692266568371,1693238832489,209,162,47
2039,1693238832489,1692266568422,1692266568587,1693238832707,218,165,53
2040,1693238832707,1692266568643,1692266568807,1693238832925,218,164,54
2041,1693238832926,1692266568847,1692266569010,1693238833128,202,163,39
2042,1693238833128,1692266569059,1692266569224,1693238833343,215,165,50
2043,1693238833343,1692266569259,1692266569422,1693238833540,197,163,34
2044,1693238833540,1692266569466,1692266569629,1693238833748,208,163,45
2045,1693238833748,1692266569694,1692266569861,1693238833979,231,167,64
2046,1693238833979,1692266569895,1692266570057,1693238834175,196,162,34
2047,1693238834175,1692266570085,1692266570248,1693238834366,191,163,28
2048,1693238834366,1692266570286,1692266570448,1693238834567,201,162,39
2049,1693238834567,1692266570487,1692266570649,1693238834767,200,162,38
2050,1693238834767,1692266570688,1692266570850,1693238834968,201,162,39
2051,1693238834968,1692266570896,1692266571059,1693238835177,209,163,46
2052,1693238835177,1692266571085,1692266571246,1693238835364,187,161,26
2053,1693238835364,1692266571281,1692266571444,1693238835562,198,163,35
2054,1693238835562,1692266571477,1692266571638,1693238835756,194,161,33
2055,1693238835757,1692266571690,1692266571852,1693238835971,214,162,52
2056,1693238835971,1692266571920,1692266572083,1693238836201,230,163,67
2057,1693238836202,1692266572141,1692266572304,1693238836422,220,163,57
2058,1693238836422,1692266572360,1692266572524,1693238836642,220,164,56
2059,1693238836642,1692266572558,1692266572724,1693238836842,200,166,34
2060,1693238836842,1692266572778,1692266572941,1693238837059,217,163,54
2061,1693238837059,1692266572968,1692266573129,1693238837248,189,161,28
2062,1693238837248,1692266573174,1692266573339,1693238837457,209,165,44
2063,1693238837457,1692266573385,1692266573549,1693238837667,210,164,46
2064,1693238837667,1692266573580,1692266573743,1693238837861,194,163,31
2065,1693238837861,1692266573798,1692266573961,1693238838080,219,163,56
2066,1693238838080,1692266574003,1692266574165,1693238838283,203,162,41
2067,1693238838283,1692266574217,1692266574380,1693238838498,215,163,52
2068,1693238838498,1692266574426,1692266574590,1693238838710,212,164,48
2069,1693238838710,1692266574633,1692266574797,1693238838915,205,164,41
2070,1693238838915,1692266574823,1692266574985,1693238839104,189,162,27
2071,1693238839104,1692266575021,1692266575183,1693238839301,197,162,35
2072,1693238839301,1692266575216,1692266575378,1693238839497,196,162,34
2073,1693238839497,1692266575409,1692266575572,1693238839799,302,163,139
2074,1693238839799,1692266575709,1692266575873,1693238840059,260,164,96
2075,1693238840059,1692266575985,1692266576148,1693238840267,208,163,45
2076,1693238840267,1692266576199,1692266576362,1693238840480,213,163,50
2077,1693238840480,1692266576415,1692266576578,1693238840697,217,163,54
2078,1693238840697,1692266576626,1692266576790,1693238840908,211,164,47
2079,1693238840908,1692266576844,1692266577009,1693238841127,219,165,54
2080,1693238841127,1692266577044,1692266577207,1693238841325,198,163,35
2081,1693238841325,1692266577262,1692266577426,1693238841544,219,164,55
2082,1693238841544,1692266577458,1692266577621,1693238841739,195,163,32
2083,1693238841739,1692266577662,1692266577824,1693238841942,203,162,41
2084,1693238841942,1692266577857,1692266578020,1693238842138,196,163,33
2085,1693238842138,1692266578062,1692266578226,1693238842344,206,164,42
2086,1693238842344,1692266578272,1692266578435,1693238842554,210,163,47
2087,1693238842554,1692266578465,1692266578627,1693238842746,192,162,30
2088,1693238842746,1692266578663,1692266578825,1693238842943,197,162,35
2089,1693238842943,1692266578858,1692266579021,1693238843139,196,163,33
2090,1693238843140,1692266579062,1692266579224,1693238843342,202,162,40
2091,1693238843342,1692266579256,1692266579419,1693238843537,195,163,32
2092,1693238843537,1692266579475,1692266579638,1693238843756,219,163,56
2093,1693238843756,1692266579681,1692266579845,1693238843963,207,164,43
2094,1693238843963,1692266579888,1692266580051,1693238844169,206,163,43
2095,1693238844169,1692266580087,1692266580250,1693238844368,199,163,36
2096,1693238844368,1692266580303,1692266580467,1693238844586,218,164,54
2097,1693238844586,1692266580523,1692266580687,1693238844805,219,164,55
2098,1693238844805,1692266580735,1692266580898,1693238845017,212,163,49
2099,1693238845017,1692266580931,1692266581095,1693238845213,196,164,32
2100,1693238845213,1692266581144,1692266581307,1693238845426,213,163,50
2101,1693238845426,1692266581340,1692266581503,1693238845621,195,163,32
2102,1693238845621,1692266581553,1692266581717,1693238845836,215,164,51
2103,1693238845836,1692266581753,1692266581914,1693238846032,196,161,35
2104,1693238846032,1692266581933,1692266582095,1693238846213,181,162,19
2105,1693238846213,1692266582159,1692266582324,1693238846443,230,165,65
2106,1693238846443,1692266582374,1692266582537,1693238846655,212,163,49
2107,1693238846655,1692266582587,1692266582751,1693238846869,214,164,50
2108,1693238846869,1692266582776,1692266582939,1693238847057,188,163,25
2109,1693238847057,1692266582995,1692266583160,1693238847279,222,165,57
2110,1693238847279,1692266583215,1692266583378,1693238847496,217,163,54
2111,1693238847496,1692266583420,1692266583584,1693238847702,206,164,42
2112,1693238847702,1692266583625,1692266583788,1693238847906,204,163,41
2113,1693238847907,1692266583835,1692266583998,1693238848116,209,163,46
2114,1693238848117,1692266584027,1692266584189,1693238848309,192,162,30
2115,1693238848309,1692266584229,1692266584392,1693238848510,201,163,38
2116,1693238848510,1692266584413,1692266584575,1693238848693,183,162,21
2117,1693238848693,1692266584620,1692266584784,1693238848902,209,164,45
2118,1693238848902,1692266584806,1692266584968,1693238849086,184,162,22
2119,1693238849086,1692266585001,1692266585164,1693238849282,196,163,33
2120,1693238849282,1692266585197,1692266585358,1693238849476,194,161,33
2121,1693238849476,1692266585373,1692266585534,1693238849652,176,161,15
2122,1693238849653,1692266585568,1692266585731,1693238849849,196,163,33
2123,1693238849849,1692266585786,1692266585951,1693238850069,220,165,55
2124,1693238850069,1692266585987,1692266586150,1693238850268,199,163,36
2125,1693238850268,1692266586163,1692266586324,1693238850442,174,161,13
2126,1693238850442,1692266586377,1692266586542,1693238850660,218,165,53
2127,1693238850661,1692266586584,1692266586749,1693238850867,206,165,41
2128,1693238850867,1692266586783,1692266586946,1693238851064,197,163,34
2129,1693238851065,1692266586999,1692266587163,1693238851281,216,164,52
2130,1693238851281,1692266587196,1692266587358,1693238851476,195,162,33
2131,1693238851476,1692266587396,1692266587559,1693238851678,202,163,39
2132,1693238851678,1692266587607,1692266587772,1693238851890,212,165,47
2133,1693238851890,1692266587811,1692266587976,1693238852094,204,165,39
2134,1693238852094,1692266588034,1692266588198,1693238852317,223,164,59
2135,1693238852317,1692266588234,1692266588396,1693238852514,197,162,35
2136,1693238852514,1692266588449,1692266588613,1693238852733,219,164,55
2137,1693238852733,1692266588684,1692266588848,1693238852966,233,164,69
2138,1693238852966,1692266588882,1692266589044,1693238853162,196,162,34
2139,1693238853162,1692266589069,1692266589232,1693238853351,189,163,26
2140,1693238853351,1692266589283,1692266589446,1693238853564,213,163,50
2141,1693238853564,1692266589477,1692266589638,1693238853756,192,161,31
2142,1693238853756,1692266589699,1692266589861,1693238853980,224,162,62
2143,1693238853980,1692266589910,1692266590073,1693238854193,213,163,50
2144,1693238854193,1692266590107,1692266590268,1693238854386,193,161,32
2145,1693238854386,1692266590330,1692266590494,1693238854612,226,164,62
2146,1693238854612,1692266590540,1692266590703,1693238854821,209,163,46
2147,1693238854821,1692266590738,1692266590900,1693238855018,197,162,35
2148,1693238855018,1692266590941,1692266591103,1693238855221,203,162,41
2149,1693238855221,1692266591154,1692266591318,1693238855443,222,164,58
2150,1693238855443,1692266591384,1692266591548,1693238855666,223,164,59
2151,1693238855666,1692266591580,1692266591741,1693238855859,193,161,32
2152,1693238855859,1692266591776,1692266591939,1693238856057,198,163,35
2153,1693238856058,1692266591983,1692266592147,1693238856265,207,164,43
2154,1693238856265,1692266592185,1692266592348,1693238856467,202,163,39
2155,1693238856468,1692266592393,1692266592555,1693238856673,205,162,43
2156,1693238856673,1692266592612,1692266592776,1693238856894,221,164,57
2157,1693238856894,1692266592807,1692266592968,1693238857086,192,161,31
2158,1693238857086,1692266593006,1692266593168,1693238857286,200,162,38
2159,1693238857286,1692266593218,1692266593382,1693238857500,214,164,50
2160,1693238857500,1692266593415,1692266593576,1693238857694,194,161,33
2161,1693238857855,1692266593772,1692266593975,1693238858209,354,203,151
2162,1693238858209,1692266594122,1692266594321,1693238858516,307,199,108
2163,1693238858516,1692266594417,1692266594614,1693238858732,216,197,19
2164,1693238858733,1692266594642,1692266594843,1693238858961,228,201,27
2165,1693238858961,1692266594871,1692266595088,1693238859207,246,217,29
2166,1693238859207,1692266595129,1692266595338,1693238859457,250,209,41
2167,1693238859457,1692266595399,1692266595630,1693238859748,291,231,60
2168,1693238859748,1692266595671,1692266595882,1693238860000,252,211,41
2169,1693238860000,1692266595932,1692266596162,1693238860280,280,230,50
2170,1693238860280,1692266596227,1692266596435,1693238860553,273,208,65
2171,1693238860554,1692266596484,1692266596716,1693238860870,316,232,84
2172,1693238860870,1692266596791,1692266597032,1693238861150,280,241,39
2173,1693238861150,1692266597064,1692266597280,1693238861399,249,216,33
2174,1693238861399,1692266597328,1692266597574,1693238861693,294,246,48
2175,1693238861693,1692266597627,1692266597866,1693238861984,291,239,52
2176,1693238861984,1692266597932,1692266598131,1693238862249,265,199,66
2177,1693238862249,1692266598190,1692266598392,1693238862511,262,202,60
2178,1693238862511,1692266598449,1692266598651,1693238862770,259,202,57
2179,1693238862770,1692266598721,1692266598956,1693238863075,305,235,70
2180,1693238863075,1692266598997,1692266599232,1693238863354,279,235,44
2181,1693238863354,1692266599263,1692266599460,1693238863580,226,197,29
2182,1693238863580,1692266599517,1692266599711,1693238863829,249,194,55
2183,1693238863829,1692266599771,1692266599974,1693238864147,318,203,115
2184,1693238864147,1692266600068,1692266600289,1693238864455,308,221,87
2185,1693238864455,1692266600379,1692266600569,1693238864761,306,190,116
2186,1693238864761,1692266600670,1692266600856,1693238864975,214,186,28
2187,1693238864975,1692266600903,1692266601093,1693238865216,241,190,51
2188,1693238865216,1692266601130,1692266601336,1693238865455,239,206,33
2189,1693238865455,1692266601390,1692266601587,1693238865706,251,197,54
2190,1693238865706,1692266601634,1692266601812,1693238865930,224,178,46
2191,1693238865930,1692266601845,1692266602022,1693238866140,210,177,33
2192,1693238866140,1692266602064,1692266602251,1693238866369,229,187,42
2193,1693238866369,1692266602312,1692266602513,1693238866632,263,201,62
2194,1693238866632,1692266602549,1692266602746,1693238866864,232,197,35
2195,1693238866864,1692266602799,1692266602989,1693238867107,243,190,53
2196,1693238867107,1692266603037,1692266603229,1693238867347,240,192,48
2197,1693238867347,1692266603263,1692266603471,1693238867589,242,208,34
2198,1693238867589,1692266603523,1692266603726,1693238867846,257,203,54
2199,1693238867846,1692266603797,1692266603988,1693238868106,260,191,69
2200,1693238868106,1692266604030,1692266604245,1693238868448,342,215,127
2201,1693238868448,1692266604381,1692266604592,1693238868710,262,211,51
2202,1693238868710,1692266604618,1692266604808,1693238868927,217,190,27
2203,1693238868927,1692266604878,1692266605114,1693238869233,306,236,70
2204,1693238869233,1692266605165,1692266605439,1693238869558,325,274,51
2205,1693238869558,1692266605482,1692266605687,1693238869805,247,205,42
2206,1693238869805,1692266605709,1692266605901,1693238870020,215,192,23
2207,1693238870020,1692266605961,1692266606170,1693238870390,370,209,161
2208,1693238870390,1692266606321,1692266606542,1693238870660,270,221,49
2209,1693238870660,1692266606592,1692266606814,1693238870933,273,222,51
2210,1693238870933,1692266606854,1692266607079,1693238871316,383,225,158
2211,1693238871316,1692266607243,1692266607472,1693238871591,275,229,46
2212,1693238871591,1692266607527,1692266607724,1693238871842,251,197,54
2213,1693238871842,1692266607769,1692266607982,1693238872100,258,213,45
2214,1693238872100,1692266608028,1692266608245,1693238872441,341,217,124
2215,1693238872441,1692266608365,1692266608577,1693238872695,254,212,42
2216,1693238872695,1692266608624,1692266608829,1693238872950,255,205,50
2217,1693238872950,1692266608866,1692266609082,1693238873200,250,216,34
2218,1693238873200,1692266609115,1692266609327,1693238873465,265,212,53
2219,1693238873465,1692266609377,1692266609575,1693238873693,228,198,30
2220,1693238873693,1692266609630,1692266609833,1693238873952,259,203,56
2221,1693238873952,1692266609887,1692266610112,1693238874231,279,225,54
2222,1693238874231,1692266610161,1692266610409,1693238874528,297,248,49
2223,1693238874528,1692266610464,1692266610702,1693238874820,292,238,54
2224,1693238874820,1692266610767,1692266610964,1693238875083,263,197,66
2225,1693238875083,1692266610995,1692266611190,1693238875309,226,195,31
2226,1693238875309,1692266611230,1692266611441,1693238875559,250,211,39
2227,1693238875559,1692266611496,1692266611755,1693238875874,315,259,56
2228,1693238875874,1692266611803,1692266612038,1693238876157,283,235,48
2229,1693238876157,1692266612083,1692266612284,1693238876402,245,201,44
2230,1693238876402,1692266612348,1692266612572,1693238876690,288,224,64
2231,1693238876690,1692266612614,1692266612836,1693238876954,264,222,42
2232,1693238876954,1692266612880,1692266613099,1693238877218,264,219,45
2233,1693238877218,1692266613149,1692266613389,1693238877508,290,240,50
2234,1693238877508,1692266613453,1692266613681,1693238877800,292,228,64
2235,1693238877801,1692266613730,1692266613930,1693238878048,247,200,47
2236,1693238878048,1692266613988,1692266614232,1693238878386,338,244,94
2237,1693238878386,1692266614313,1692266614570,1693238878758,372,257,115
2238,1693238878758,1692266614684,1692266614882,1693238879000,242,198,44
2239,1693238879000,1692266614927,1692266615117,1693238879235,235,190,45
2240,1693238879235,1692266615160,1692266615348,1693238879467,232,188,44
2241,1693238879467,1692266615395,1692266615603,1693238879722,255,208,47
2242,1693238879722,1692266615642,1692266615877,1693238879998,276,235,41
2243,1693238879998,1692266615936,1692266616156,1693238880327,329,220,109
2244,1693238880327,1692266616261,1692266616483,1693238880601,274,222,52
2245,1693238880602,1692266616550,1692266616766,1693238880884,282,216,66
2246,1693238880884,1692266616816,1692266617040,1693238881158,274,224,50
2247,1693238881158,1692266617099,1692266617318,1693238881435,277,219,58
2248,1693238881435,1692266617355,1692266617559,1693238881677,242,204,38
2249,1693238881677,1692266617601,1692266617834,1693238881953,276,233,43
2250,1693238881953,1692266617875,1692266618109,1693238882227,274,234,40
2251,1693238882228,1692266618159,1692266618388,1693238882506,278,229,49
2252,1693238882506,1692266618432,1692266618662,1693238882780,274,230,44
2253,1693238882781,1692266618728,1692266618964,1693238883082,301,236,65
2254,1693238883083,1692266619006,1692266619272,1693238883391,308,266,42
2255,1693238883391,1692266619327,1692266619535,1693238883702,311,208,103
2256,1693238883702,1692266619644,1692266619853,1693238884012,310,209,101
2257,1693238884012,1692266619935,1692266620200,1693238884422,410,265,145
2258,1693238884422,1692266620345,1692266620552,1693238884671,249,207,42
2259,1693238884671,1692266620590,1692266620773,1693238884891,220,183,37
2260,1693238884891,1692266620810,1692266621002,1693238885120,229,192,37
2261,1693238885120,1692266621046,1692266621256,1693238885374,254,210,44
2262,1693238885374,1692266621293,1692266621484,1693238885603,229,191,38
2263,1693238885603,1692266621540,1692266621730,1693238885849,246,190,56
2264,1693238885849,1692266621779,1692266621988,1693238886106,257,209,48
2265,1693238886106,1692266622049,1692266622244,1693238886364,258,195,63
2266,1693238886364,1692266622289,1692266622487,1693238886605,241,198,43
2267,1693238886605,1692266622530,1692266622737,1693238886856,251,207,44
2268,1693238886856,1692266622777,1692266622972,1693238887090,234,195,39
2269,1693238887090,1692266623000,1692266623186,1693238887304,214,186,28
2270,1693238887304,1692266623237,1692266623448,1693238887566,262,211,51
2271,1693238887566,1692266623492,1692266623685,1693238887803,237,193,44
2272,1693238887803,1692266623741,1692266623907,1693238888024,221,166,55
2273,1693238888031,1692266623954,1692266624117,1693238888235,204,163,41
2274,1693238888235,1692266624182,1692266624346,1693238888463,228,164,64
2275,1693238888463,1692266624391,1692266624554,1693238888672,209,163,46
2276,1693238888672,1692266624592,1692266624755,1693238888873,201,163,38
2277,1693238888873,1692266624805,1692266624970,1693238889088,215,165,50
2278,1693238889088,1692266625034,1692266625198,1693238889316,228,164,64
2279,1693238889316,1692266625237,1692266625399,1693238889517,201,162,39
2280,1693238889517,1692266625450,1692266625613,1693238889730,213,163,50
2281,1693238889730,1692266625651,1692266625813,1693238889931,201,162,39
2282,1693238889931,1692266625843,1692266626005,1693238890123,192,162,30
2283,1693238890123,1692266626048,1692266626211,1693238890328,205,163,42
2284,1693238890328,1692266626262,1692266626425,1693238890542,214,163,51
2285,1693238890542,1692266626470,1692266626633,1693238890751,209,163,46
2286,1693238890751,1692266626681,1692266626845,1693238890962,211,164,47
2287,1693238890962,1692266626871,1692266627032,1693238891150,188,161,27
2288,1693238891150,1692266627078,1692266627241,1693238891359,209,163,46
2289,1693238891360,1692266627290,1692266627453,1693238891571,211,163,48
2290,1693238891571,1692266627495,1692266627658,1693238891776,205,163,42
2291,1693238891776,1692266627703,1692266627865,1693238891982,206,162,44
2292,1693238891982,1692266627914,1692266628077,1693238892217,235,163,72
2293,1693238892217,1692266628142,1692266628305,1693238892422,205,163,42
2294,1693238892422,1692266628348,1692266628510,1693238892628,206,162,44
2295,1693238892628,1692266628552,1692266628714,1693238892832,204,162,42
2296,1693238892832,1692266628758,1692266628923,1693238893040,208,165,43
2297,1693238893040,1692266628949,1692266629111,1693238893229,189,162,27
2298,1693238893229,1692266629153,1692266629316,1693238893434,205,163,42
2299,1693238893434,1692266629371,1692266629534,1693238893652,218,163,55
2300,1693238893652,1692266629573,1692266629736,1693238893853,201,163,38
2301,1693238893853,1692266629776,1692266629938,1693238894056,203,162,41
2302,1693238894056,1692266629975,1692266630136,1693238894254,198,161,37
2303,1693238894254,1692266630169,1692266630330,1693238894447,193,161,32
2304,1693238894447,1692266630355,1692266630516,1693238894634,187,161,26
2305,1693238894634,1692266630564,1692266630727,1693238894845,211,163,48
2306,1693238894845,1692266630791,1692266630954,1693238895073,228,163,65
2307,1693238895073,1692266630993,1692266631158,1693238895276,203,165,38
2308,1693238895276,1692266631190,1692266631352,1693238895470,194,162,32
2309,1693238895470,1692266631401,1692266631564,1693238895682,212,163,49
2310,1693238895682,1692266631601,1692266631765,1693238895882,200,164,36
2311,1693238895883,1692266631801,1692266631964,1693238896082,199,163,36
2312,1693238896082,1692266632018,1692266632181,1693238896299,217,163,54
2313,1693238896299,1692266632235,1692266632398,1693238896516,217,163,54
2314,1693238896516,1692266632466,1692266632630,1693238896748,232,164,68
2315,1693238896748,1692266632679,1692266632842,1693238896960,212,163,49
2316,1693238896960,1692266632901,1692266633064,1693238897182,222,163,59
2317,1693238897182,1692266633113,1692266633276,1693238897394,212,163,49
2318,1693238897394,1692266633321,1692266633483,1693238897600,206,162,44
2319,1693238897600,1692266633521,1692266633685,1693238897803,203,164,39
2320,1693238897803,1692266633722,1692266633885,1693238898003,200,163,37
2321,1693238898003,1692266633939,1692266634102,1693238898220,217,163,54
2322,1693238898220,1692266634150,1692266634313,1693238898431,211,163,48
2323,1693238898431,1692266634344,1692266634506,1693238898623,192,162,30
2324,1693238898624,1692266634541,1692266634705,1693238898822,198,164,34
2325,1693238898822,1692266634735,1692266634898,1693238899016,194,163,31
2326,1693238899016,1692266634936,1692266635098,1693238899216,200,162,38
2327,1693238899216,1692266635131,1692266635293,1693238899411,195,162,33
2328,1693238899411,1692266635337,1692266635500,1693238899618,207,163,44
2329,1693238899618,1692266635792,1692266635955,1693238900072,454,163,291
2330,1693238900072,1692266636001,1692266636164,1693238900281,209,163,46
2331,1693238900281,1692266636197,1692266636359,1693238900476,195,162,33
2332,1693238900476,1692266636399,1692266636562,1693238900680,204,163,41
2333,1693238900680,1692266636608,1692266636770,1693238900889,209,162,47
2334,1693238900889,1692266636815,1692266636977,1693238901094,205,162,43
2335,1693238901095,1692266637017,1692266637180,1693238901298,203,163,40
2336,1693238901298,1692266637213,1692266637374,1693238901492,194,161,33
2337,1693238901492,1692266637433,1692266637596,1693238901713,221,163,58
2338,1693238901713,1692266637631,1692266637792,1693238901910,197,161,36
2339,1693238901910,1692266637863,1692266638027,1693238902144,234,164,70
2340,1693238902145,1692266638063,1692266638225,1693238902343,198,162,36
2341,1693238902343,1692266638286,1692266638449,1693238902566,223,163,60
2342,1693238902566,1692266638547,1692266638711,1693238902830,264,164,100
2343,1693238902831,1692266638768,1692266638930,1693238903048,217,162,55
2344,1693238903048,1692266638988,1692266639152,1693238903269,221,164,57
2345,1693238903269,1692266639199,1692266639363,1693238903480,211,164,47
2346,1693238903480,1692266639382,1692266639545,1693238903663,183,163,20
2347,1693238903663,1692266639595,1692266639758,1693238903876,213,163,50
2348,1693238903876,1692266639791,1692266639953,1693238904214,338,162,176
2349,1693238904214,1692266640130,1692266640292,1693238904739,525,162,363
2350,1693238904739,1692266640662,1692266640825,1693238905260,521,163,358
2351,1693238905261,1692266641178,1692266641339,1693238905789,528,161,367
2352,1693238905789,1692266641699,1692266641860,1693238905991,202,161,41
2353,1693238905991,1692266641915,1692266642079,1693238906196,205,164,41
2354,1693238906196,1692266642146,1692266642309,1693238906645,449,163,286
2355,1693238906645,1692266642575,1692266642738,1693238906856,211,163,48
2356,1693238906856,1692266642772,1692266642933,1693238907167,311,161,150
2357,1693238907168,1692266643082,1692266643248,1693238907365,197,166,31
2358,1693238907365,1692266643281,1692266643445,1693238907692,327,164,163
2359,1693238907693,1692266643633,1692266643799,1693238907926,233,166,67
2360,1693238907926,1692266643832,1692266643993,1693238908216,290,161,129
2361,1693238908216,1692266644141,1692266644303,1693238908421,205,162,43
2362,1693238908421,1692266644361,1692266644524,1693238908742,321,163,158
2363,1693238908742,1692266644658,1692266644820,1693238908937,195,162,33
2364,1693238908938,1692266644857,1692266645020,1693238909268,330,163,167
2365,1693238909268,1692266645195,1692266645357,1693238909497,229,162,67
2366,1693238909497,1692266645419,1692266645583,1693238909788,291,164,127
2367,1693238909788,1692266645713,1692266645874,1693238909992,204,161,43
2368,1693238909992,1692266645915,1692266646078,1693238910313,321,163,158
2369,1693238910313,1692266646237,1692266646399,1693238910517,204,162,42
2370,1693238910517,1692266646431,1692266646592,1693238910842,325,161,164
2371,1693238910842,1692266646766,1692266646929,1693238911053,211,163,48
2372,1693238911053,1692266646974,1692266647137,1693238911254,201,163,38
2373,1693238911254,1692266647177,1692266647343,1693238911460,206,166,40
2374,1693238911460,1692266647389,1692266647553,1693238911888,428,164,264
2375,1693238911888,1692266647796,1692266647959,1693238912077,189,163,26
2376,1693238912077,1692266648002,1692266648166,1693238912284,207,164,43
2377,1693238912284,1692266648202,1692266648363,1693238912482,198,161,37
2378,1693238912482,1692266648430,1692266648596,1693238912713,231,166,65
2379,1693238912713,1692266648690,1692266648855,1693238912972,259,165,94
2380,1693238912972,1692266648904,1692266649066,1693238913184,212,162,50
2381,1693238913184,1692266649104,1692266649265,1693238913383,199,161,38
2382,1693238913383,1692266649310,1692266649472,1693238913590,207,162,45
2383,1693238913590,1692266649506,1692266649667,1693238913784,194,161,33
2384,1693238913785,1692266649718,1692266649880,1693238913998,213,162,51
2385,1693238913998,1692266649929,1692266650093,1693238914210,212,164,48
2386,1693238914210,1692266650127,1692266650288,1693238914406,196,161,35
2387,1693238914406,1692266650340,1692266650503,1693238914621,215,163,52
2388,1693238914621,1692266650536,1692266650699,1693238914816,195,163,32
2389,1693238914816,1692266650759,1692266650924,1693238915041,225,165,60
2390,1693238915041,1692266650967,1692266651131,1693238915248,207,164,43
2391,1693238915248,1692266651156,1692266651318,1693238915435,187,162,25
2392,1693238915435,1692266651365,1692266651528,1693238915645,210,163,47
2393,1693238915645,1692266651556,1692266651718,1693238915835,190,162,28
2394,1693238915835,1692266651772,1692266651935,1693238916052,217,163,54
2395,1693238916052,1692266651971,1692266652133,1693238916250,198,162,36
2396,1693238916250,1692266652175,1692266652337,1693238916454,204,162,42
2397,1693238916454,1692266652384,1692266652547,1693238916664,210,163,47
2398,1693238916664,1692266652581,1692266652742,1693238916860,196,161,35
2399,1693238916860,1692266652805,1692266652969,1693238917086,226,164,62
2400,1693238917086,1692266653021,1692266653185,1693238917302,216,164,52
2401,1693238917302,1692266653225,1692266653390,1693238917507,205,165,40
2402,1693238917507,1692266653429,1692266653592,1693238917709,202,163,39
2403,1693238917709,1692266653619,1692266653782,1693238917899,190,163,27
2404,1693238917899,1692266653807,1692266653969,1693238918086,187,162,25
