request_number,request_time_ms,request_received_time_ms,response_time_ms,response_received_time_ms,end_to_end_latency,compute_time,transmission_time
1,1697679993498,1697679994530,1697679996024,1697679995286,1788,1494,294
2,1697679995299,1697679996340,1697679997895,1697679997138,1839,1555,284
3,1697679997149,1697679998153,1697679999695,1697679998997,1848,1542,306
4,1697679999010,1697679999993,1697680001584,1697680000939,1929,1591,338
5,1697680000952,1697680001957,1697680003463,1697680002712,1760,1506,254
6,1697680002725,1697680003722,1697680005182,1697680004503,1778,1460,318
7,1697680004515,1697680005499,1697680006965,1697680006276,1761,1466,295
8,1697680006289,1697680007323,1697680008788,1697680008027,1738,1465,273
9,1697680008040,1697680009034,1697680010503,1697680009756,1716,1469,247
10,1697680009769,1697680010824,1697680012265,1697680011524,1755,1441,314
11,1697680011537,1697680012528,1697680013997,1697680013349,1812,1469,343
12,1697680013361,1697680014427,1697680015851,1697680015115,1754,1424,330
13,1697680015125,1697680016110,1697680017600,1697680016867,1742,1490,252
14,1697680016881,1697680017934,1697680019398,1697680018673,1792,1464,328
15,1697680018686,1697680019675,1697680021119,1697680020397,1711,1444,267
16,1697680020410,1697680021435,1697680022927,1697680022234,1824,1492,332
17,1697680022247,1697680023236,1697680024708,1697680023966,1719,1472,247
18,1697680023979,1697680024956,1697680026438,1697680025724,1745,1482,263
19,1697680025737,1697680026708,1697680028195,1697680027474,1737,1487,250
20,1697680027487,1697680028484,1697680029954,1697680029193,1706,1470,236
21,1697680029206,1697680030277,1697680031779,1697680031056,1850,1502,348
22,1697680031069,1697680032051,1697680033591,1697680032901,1832,1540,292
23,1697680032914,1697680033908,1697680035363,1697680034724,1810,1455,355
24,1697680034737,1697680035724,1697680037195,1697680036468,1731,1471,260
25,1697680036480,1697680037469,1697680038972,1697680038307,1827,1503,324
26,1697680038317,1697680039323,1697680040817,1697680040152,1835,1494,341
27,1697680040164,1697680041168,1697680042679,1697680042008,1844,1511,333
28,1697680042020,1697680043010,1697680044468,1697680043709,1689,1458,231
29,1697680043722,1697680044728,1697680046223,1697680045573,1851,1495,356
30,1697680045585,1697680046579,1697680048143,1697680047434,1849,1564,285
31,1697680047447,1697680048431,1697680049900,1697680049176,1729,1469,260
32,1697680049188,1697680050165,1697680051642,1697680051012,1824,1477,347
33,1697680051024,1697680052002,1697680053469,1697680052764,1740,1467,273
34,1697680052777,1697680053766,1697680055244,1697680054581,1804,1478,326
35,1697680054593,1697680055585,1697680057059,1697680056300,1707,1474,233
36,1697680056313,1697680057301,1697680058755,1697680058072,1759,1454,305
37,1697680058082,1697680059106,1697680060563,1697680059846,1764,1457,307
38,1697680059862,1697680060914,1697680062386,1697680061673,1811,1472,339
39,1697680061683,1697680062692,1697680064229,1697680063503,1820,1537,283
40,1697680063515,1697680064544,1697680066003,1697680065244,1729,1459,270
41,1697680065257,1697680066256,1697680067778,1697680067048,1791,1522,269
42,1697680067060,1697680068073,1697680069537,1697680068786,1726,1464,262
43,1697680068798,1697680069797,1697680071283,1697680070557,1759,1486,273
44,1697680070570,1697680071570,1697680073027,1697680072311,1741,1457,284
45,1697680072324,1697680073336,1697680074851,1697680074161,1837,1515,322
46,1697680074174,1697680075166,1697680076680,1697680075977,1803,1514,289
47,1697680075989,1697680076973,1697680078456,1697680077693,1704,1483,221
48,1697680077706,1697680078743,1697680080292,1697680079559,1853,1549,304
49,1697680079572,1697680080547,1697680082005,1697680081299,1727,1458,269
50,1697680081313,1697680082294,1697680083796,1697680083043,1730,1502,228
51,1697680083056,1697680084086,1697680085585,1697680084829,1773,1499,274
